6806016	1	0	6806016	0	0x2aff5d5	[IFNE_JUMP]	16953	[mandreel.js]	16894
6806016	0.549777	0.450223	3741792	3064224	0x2aff1b0	[IFEQ_JUMP]	16957	[mandreel.js]	16894
5570112	1	0	5570112	0	0x2b02290	[IFNE_JUMP]	17418	[mandreel.js]	17365
5570112	0.447951	0.552049	2495136	3074976	0x2b01ded	[IFEQ_JUMP]	17422	[mandreel.js]	17365
3741792	0.533417	0.466583	1995936	1745856	0x2aff213	[IFEQ_JUMP]	16967	[mandreel.js]	16894
2773446	1	0	2773446	0	0x2f6291a	[IFNE_JUMP]	39092	[mandreel.js]	39064
2767680	1	0	2767680	0	0x2f628e7	[IFEQ_JUMP]	39100	[mandreel.js]	39064
2495136	0.51414	0.48586	1282848	1212288	0x2b01e50	[IFEQ_JUMP]	17432	[mandreel.js]	17365
1745856	0.464749	0.535251	811384	934472	0x2aff27b	[IFEQ_JUMP]	16974	[mandreel.js]	16894
1212288	0.475397	0.524603	576318	635970	0x2b01ef7	[IFEQ_JUMP]	17444	[mandreel.js]	17365
934472	0.630689	0.369311	589361	345111	0x2aff2bf	[IFEQ_JUMP]	16978	[mandreel.js]	16894
635970	0.632002	0.367998	401934	234036	0x2b01f3e	[IFEQ_JUMP]	17448	[mandreel.js]	17365
492561	1	0	492561	0	0x2b09da7	[IFNE_JUMP]	18895	[mandreel.js]	18848
492561	0.910348	0.0896518	448402	44159	0x2b09d9a	[IFEQ_JUMP]	18961	[mandreel.js]	18848
391100	1	0	391100	0	0x3135c1e	[IFNE_JUMP]	55613	[mandreel.js]	55549
371600	1	0	371600	0	0x3135b70	[IFNE_JUMP]	55591	[mandreel.js]	55549
345111	0.000347714	0.999652	120	344991	0x2aff310	[IFEQ_JUMP]	16983	[mandreel.js]	16894
344991	1	0	344991	0	0x2aff354	[IFEQ_JUMP]	16987	[mandreel.js]	16894
288300	1	0	288300	0	0x2b02afd	[IFNE_JUMP]	17598	[mandreel.js]	17522
288300	1	0	288300	0	0x2b02a06	[IFEQ_JUMP]	17636	[mandreel.js]	17522
288300	0.983854	0.0161464	283645	4655	0x2b029b2	[IFEQ_JUMP]	17628	[mandreel.js]	17522
288300	0.855706	0.144294	246700	41600	0x2b02a6b	[IFEQ_JUMP]	17645	[mandreel.js]	17522
288300	0.838502	0.161498	241740	46560	0x2b02951	[IFEQ_JUMP]	17619	[mandreel.js]	17522
288300	0.333333	0.666667	96100	192200	0x2b02ae6	[IFEQ_JUMP]	17656	[mandreel.js]	17522
234036	1	0	234036	0	0x2b01fef	[IFEQ_JUMP]	17459	[mandreel.js]	17365
234036	0	1	0	234036	0x2b01fa8	[IFEQ_NOJUMP]	17455	[mandreel.js]	17365
192000	1	0	192000	0	0x36ae64d	[IFNE_JUMP]	94444	[mandreel.js]	93654
192000	1	0	192000	0	0x36ad4b1	[IFNE_JUMP]	94042	[mandreel.js]	93654
192000	1	0	192000	0	0x36ad36a	[IFNE_JUMP]	94000	[mandreel.js]	93654
192000	0	1	0	192000	0x32bf1bf	[IFEQ_NOJUMP]	66918	[mandreel.js]	66768
191900	0.499739	0.500261	95900	96000	0x36ae235	[IFEQ_JUMP]	94455	[mandreel.js]	93654
147855	1	0	147855	0	0x2b01098	[IFNE_JUMP]	17102	[mandreel.js]	17048
147855	0.997768	0.00223192	147525	330	0x2b00c0b	[IFEQ_JUMP]	17104	[mandreel.js]	17048
143200	0.00893855	0.991061	1280	141920	0x2b00c86	[IFEQ_JUMP]	17116	[mandreel.js]	17048
135485	1	0	135485	0	0x2b0a503	[IFNE_JUMP]	19049	[mandreel.js]	18848
135485	0.211463	0.788537	28650	106835	0x2b0a1fe	[IFEQ_JUMP]	19053	[mandreel.js]	18848
107526	0	1	0	107526	0x3224997	[IFEQ_NOJUMP]	63442	[mandreel.js]	63421
106835	0.160715	0.839285	17170	89665	0x2b0a233	[IFEQ_JUMP]	19058	[mandreel.js]	18848
102300	1	0	102300	0	0x366ddad	[IFNE_JUMP]	92031	[mandreel.js]	91805
102300	0.990225	0.00977517	101300	1000	0x366dda0	[IFEQ_JUMP]	92041	[mandreel.js]	91805
96100	1	0	96100	0	0x375a98a	[IFNE_JUMP]	98777	[mandreel.js]	98748
96100	1	0	96100	0	0x36ad614	[IFNE_JUMP]	93970	[mandreel.js]	93654
96100	1	0	96100	0	0x311cfc2	[IFNE_JUMP]	54282	[mandreel.js]	54255
96100	1	0	96100	0	0x311b48f	[IFNE_JUMP]	54038	[mandreel.js]	54013
96100	1	0	96100	0	0x2e97fcb	[IFNE_JUMP]	35914	[mandreel.js]	35882
96100	1	0	96100	0	0x2d03e0e	[IFEQ_JUMP]	22501	[mandreel.js]	22202
96100	1	0	96100	0	0x2d03d93	[IFEQ_JUMP]	22488	[mandreel.js]	22202
96100	0.998959	0.00104058	96000	100	0x311b28b	[IFEQ_JUMP]	54047	[mandreel.js]	54013
96100	0.95	0.05	91295	4805	0x2d03731	[IFEQ_JUMP]	22325	[mandreel.js]	22202
96100	0.95	0.05	91295	4805	0x2d036d2	[IFEQ_JUMP]	22313	[mandreel.js]	22202
96100	0.600364	0.399636	57695	38405	0x2d03fda	[IFEQ_JUMP]	22533	[mandreel.js]	22202
96100	0.600364	0.399636	57695	38405	0x2d037c5	[IFEQ_JUMP]	22338	[mandreel.js]	22202
96100	0	1	0	96100	0x375a412	[IFEQ_NOJUMP]	98787	[mandreel.js]	98748
96100	0	1	0	96100	0x375a407	[IFEQ_NOJUMP]	98785	[mandreel.js]	98748
96100	0	1	0	96100	0x2e97f98	[IFNE_NOJUMP]	36071	[mandreel.js]	35882
96100	0	1	0	96100	0x2e979c3	[IFEQ_NOJUMP]	35944	[mandreel.js]	35882
96100	0	1	0	96100	0x2e97958	[IFEQ_NOJUMP]	35922	[mandreel.js]	35882
96100	0	1	0	96100	0x2d03f9c	[IFEQ_NOJUMP]	22526	[mandreel.js]	22202
96100	0	1	0	96100	0x2d0355c	[IFEQ_NOJUMP]	22283	[mandreel.js]	22202
96100	0	1	0	96100	0x2d0353f	[IFEQ_NOJUMP]	22280	[mandreel.js]	22202
96100	0	1	0	96100	0x2d03522	[IFEQ_NOJUMP]	22277	[mandreel.js]	22202
96100	0	1	0	96100	0x2d03505	[IFEQ_NOJUMP]	22274	[mandreel.js]	22202
96100	0	1	0	96100	0x2d034e9	[IFEQ_NOJUMP]	22271	[mandreel.js]	22202
96100	0	1	0	96100	0x2d034cc	[IFEQ_NOJUMP]	22268	[mandreel.js]	22202
96100	0	1	0	96100	0x2d03463	[IFEQ_NOJUMP]	22259	[mandreel.js]	22202
96100	0	1	0	96100	0x2b02b18	[IFEQ_NOJUMP]	17665	[mandreel.js]	17522
96100	0.00104058	0.998959	100	96000	0x375a438	[IFEQ_JUMP]	98791	[mandreel.js]	98748
96100	0.00104058	0.998959	100	96000	0x311cf38	[IFEQ_JUMP]	54291	[mandreel.js]	54255
96100	0.00104058	0.998959	100	96000	0x2e97bda	[IFEQ_JUMP]	35984	[mandreel.js]	35882
96100	0.000988554	0.999011	95	96005	0x2d03702	[IFEQ_JUMP]	22319	[mandreel.js]	22202
96000	1	0	96000	0	0x37634b7	[IFEQ_JUMP]	100548	[mandreel.js]	100498
96000	1	0	96000	0	0x376201f	[IFEQ_JUMP]	100480	[mandreel.js]	100387
96000	1	0	96000	0	0x375a45e	[IFEQ_JUMP]	98795	[mandreel.js]	98748
96000	1	0	96000	0	0x36aeb0d	[IFNE_JUMP]	94437	[mandreel.js]	93654
96000	1	0	96000	0	0x36ae956	[IFEQ_JUMP]	94653	[mandreel.js]	93654
96000	1	0	96000	0	0x36ae617	[IFEQ_JUMP]	94557	[mandreel.js]	93654
96000	1	0	96000	0	0x36ad456	[IFEQ_JUMP]	94060	[mandreel.js]	93654
96000	1	0	96000	0	0x36ad30d	[IFEQ_JUMP]	94018	[mandreel.js]	93654
96000	1	0	96000	0	0x36ad236	[IFNE_JUMP]	93980	[mandreel.js]	93654
96000	1	0	96000	0	0x36ad0d4	[IFNE_JUMP]	93912	[mandreel.js]	93654
96000	1	0	96000	0	0x36ab243	[IFNE_JUMP]	96645	[mandreel.js]	96582
96000	1	0	96000	0	0x36aa23d	[IFNE_JUMP]	96753	[mandreel.js]	96730
96000	1	0	96000	0	0x36a98ac	[IFEQ_JUMP]	96534	[mandreel.js]	96514
96000	1	0	96000	0	0x36a69a6	[IFNE_JUMP]	95293	[mandreel.js]	95263
96000	1	0	96000	0	0x36a67a9	[IFEQ_JUMP]	95363	[mandreel.js]	95263
96000	1	0	96000	0	0x3671aa3	[IFNE_JUMP]	93378	[mandreel.js]	93337
96000	1	0	96000	0	0x36711c5	[IFEQ_JUMP]	93413	[mandreel.js]	93337
96000	1	0	96000	0	0x366e734	[IFEQ_JUMP]	92309	[mandreel.js]	91805
96000	1	0	96000	0	0x366df57	[IFEQ_JUMP]	92090	[mandreel.js]	91805
96000	1	0	96000	0	0x366df3d	[IFNE_JUMP]	91987	[mandreel.js]	91805
96000	1	0	96000	0	0x366d88f	[IFNE_JUMP]	91874	[mandreel.js]	91805
96000	1	0	96000	0	0x365993a	[IFNE_JUMP]	92675	[mandreel.js]	92649
96000	1	0	96000	0	0x36543d1	[IFNE_JUMP]	91513	[mandreel.js]	91497
96000	1	0	96000	0	0x311d472	[IFNE_JUMP]	54434	[mandreel.js]	54255
96000	1	0	96000	0	0x2e97c48	[IFEQ_JUMP]	35995	[mandreel.js]	35882
96000	0.999948	5.20833e-05	95995	5	0x36ae2ae	[IFEQ_JUMP]	94465	[mandreel.js]	93654
96000	0.998958	0.00104167	95900	100	0x36ad0c7	[IFEQ_JUMP]	93952	[mandreel.js]	93654
96000	0.988542	0.0114583	94900	1100	0x366dbc9	[IFEQ_JUMP]	91989	[mandreel.js]	91805
96000	0.2	0.8	19200	76800	0x36a6720	[IFEQ_JUMP]	95345	[mandreel.js]	95263
96000	0	1	0	96000	0x3761c95	[IFEQ_NOJUMP]	100410	[mandreel.js]	100387
96000	0	1	0	96000	0x375d663	[IFEQ_NOJUMP]	99464	[mandreel.js]	99428
96000	0	1	0	96000	0x36aeacd	[IFEQ_NOJUMP]	94695	[mandreel.js]	93654
96000	0	1	0	96000	0x36aeac3	[IFNE_NOJUMP]	94694	[mandreel.js]	93654
96000	0	1	0	96000	0x36ae874	[IFEQ_NOJUMP]	94636	[mandreel.js]	93654
96000	0	1	0	96000	0x36ae852	[IFEQ_NOJUMP]	94631	[mandreel.js]	93654
96000	0	1	0	96000	0x36ae846	[IFNE_NOJUMP]	94630	[mandreel.js]	93654
96000	0	1	0	96000	0x36ae607	[IFEQ_NOJUMP]	94554	[mandreel.js]	93654
96000	0	1	0	96000	0x36ad43a	[IFEQ_NOJUMP]	94057	[mandreel.js]	93654
96000	0	1	0	96000	0x36ad37f	[IFEQ_NOJUMP]	94040	[mandreel.js]	93654
96000	0	1	0	96000	0x36ad323	[IFEQ_NOJUMP]	94023	[mandreel.js]	93654
96000	0	1	0	96000	0x36ad2ed	[IFEQ_NOJUMP]	94014	[mandreel.js]	93654
96000	0	1	0	96000	0x36acf9b	[IFEQ_NOJUMP]	93919	[mandreel.js]	93654
96000	0	1	0	96000	0x36ab1da	[IFEQ_NOJUMP]	96655	[mandreel.js]	96582
96000	0	1	0	96000	0x36ab1ce	[IFEQ_NOJUMP]	96653	[mandreel.js]	96582
96000	0	1	0	96000	0x36aa0fd	[IFEQ_NOJUMP]	96767	[mandreel.js]	96730
96000	0	1	0	96000	0x36aa0d7	[IFEQ_NOJUMP]	96763	[mandreel.js]	96730
96000	0	1	0	96000	0x36aa0cb	[IFEQ_NOJUMP]	96761	[mandreel.js]	96730
96000	0	1	0	96000	0x36a9887	[IFEQ_NOJUMP]	96530	[mandreel.js]	96514
96000	0	1	0	96000	0x36a6968	[IFNE_NOJUMP]	95422	[mandreel.js]	95263
96000	0	1	0	96000	0x36a6954	[IFEQ_NOJUMP]	95416	[mandreel.js]	95263
96000	0	1	0	96000	0x36a6926	[IFNE_NOJUMP]	95414	[mandreel.js]	95263
96000	0	1	0	96000	0x36a65b2	[IFEQ_NOJUMP]	95307	[mandreel.js]	95263
96000	0	1	0	96000	0x36a659e	[IFEQ_NOJUMP]	95304	[mandreel.js]	95263
96000	0	1	0	96000	0x36a6578	[IFEQ_NOJUMP]	95300	[mandreel.js]	95263
96000	0	1	0	96000	0x3671a3a	[IFNE_NOJUMP]	93581	[mandreel.js]	93337
96000	0	1	0	96000	0x36710c1	[IFEQ_NOJUMP]	93393	[mandreel.js]	93337
96000	0	1	0	96000	0x367109b	[IFEQ_NOJUMP]	93389	[mandreel.js]	93337
96000	0	1	0	96000	0x367108f	[IFEQ_NOJUMP]	93387	[mandreel.js]	93337
96000	0	1	0	96000	0x366e756	[IFNE_NOJUMP]	92316	[mandreel.js]	91805
96000	0	1	0	96000	0x366e6e1	[IFNE_NOJUMP]	92303	[mandreel.js]	91805
96000	0	1	0	96000	0x366e308	[IFNE_NOJUMP]	92194	[mandreel.js]	91805
96000	0	1	0	96000	0x366df30	[IFEQ_NOJUMP]	92082	[mandreel.js]	91805
96000	0	1	0	96000	0x366d9e8	[IFNE_NOJUMP]	91946	[mandreel.js]	91805
96000	0	1	0	96000	0x36597cc	[IFEQ_NOJUMP]	92683	[mandreel.js]	92649
96000	0	1	0	96000	0x311b30c	[IFEQ_NOJUMP]	54060	[mandreel.js]	54013
96000	0.00104167	0.998958	100	95900	0x311d45b	[IFEQ_JUMP]	54445	[mandreel.js]	54255
95900	0	1	0	95900	0x36ad229	[IFEQ_NOJUMP]	93992	[mandreel.js]	93654
91420	0.998972	0.00102822	91326	94	0x2b0a4f6	[IFEQ_JUMP]	19113	[mandreel.js]	18848
89665	0.104968	0.895032	9412	80253	0x2b0a260	[IFEQ_JUMP]	19062	[mandreel.js]	18848
80253	0.191856	0.808144	15397	64856	0x2b0a28d	[IFEQ_JUMP]	19066	[mandreel.js]	18848
77840	1	0	77840	0	0x2b0af85	[IFNE_JUMP]	19219	[mandreel.js]	19130
77840	0.00044964	0.99955	35	77805	0x2b0ac94	[IFEQ_JUMP]	19220	[mandreel.js]	19130
77805	0.0869481	0.913052	6765	71040	0x2b0aef1	[IFEQ_JUMP]	19257	[mandreel.js]	19130
76800	0	1	0	76800	0x36a675c	[IFEQ_NOJUMP]	95348	[mandreel.js]	95263
71040	0.459952	0.540048	32675	38365	0x2b0af5e	[IFEQ_JUMP]	19268	[mandreel.js]	19130
64856	0.0719286	0.928071	4665	60191	0x2b0a2ba	[IFEQ_JUMP]	19070	[mandreel.js]	18848
63858	0.727051	0.272949	46428	17430	0x2aff06e	[IFEQ_JUMP]	16929	[mandreel.js]	16894
58898	0.804408	0.195592	47378	11520	0x2b01cd6	[IFEQ_JUMP]	17398	[mandreel.js]	17365
57695	0	1	0	57695	0x2b0b41e	[IFEQ_NOJUMP]	19346	[mandreel.js]	19295
57695	0	1	0	57695	0x2b0b3f1	[IFEQ_NOJUMP]	19342	[mandreel.js]	19295
57695	0	1	0	57695	0x2b0b3c4	[IFEQ_NOJUMP]	19338	[mandreel.js]	19295
57695	0	1	0	57695	0x2b0b397	[IFEQ_NOJUMP]	19334	[mandreel.js]	19295
51100	1	0	51100	0	0x3135d29	[IFNE_JUMP]	55583	[mandreel.js]	55549
51100	0.500978	0.499022	25600	25500	0x3135d7e	[IFEQ_JUMP]	55664	[mandreel.js]	55549
51100	0.500978	0.499022	25600	25500	0x3135d36	[IFEQ_JUMP]	55657	[mandreel.js]	55549
44171	0.000135836	0.999864	6	44165	0x2b09a58	[IFEQ_JUMP]	18878	[mandreel.js]	18848
44165	0.999864	0.000135854	44159	6	0x2b0a0ba	[IFEQ_JUMP]	19026	[mandreel.js]	18848
44165	0.86958	0.13042	38405	5760	0x2b09dda	[IFEQ_JUMP]	18970	[mandreel.js]	18848
44165	0.000135854	0.999864	6	44159	0x2b09a8b	[IFEQ_JUMP]	18883	[mandreel.js]	18848
38405	1	0	38405	0	0x2d0400c	[IFEQ_JUMP]	22538	[mandreel.js]	22202
38405	0.99987	0.000130191	38400	5	0x2b0aaa1	[IFEQ_JUMP]	19173	[mandreel.js]	19130
38405	0	1	0	38405	0x2b0b732	[IFNE_NOJUMP]	19447	[mandreel.js]	19295
38405	0	1	0	38405	0x2b0b678	[IFEQ_NOJUMP]	19413	[mandreel.js]	19295
38405	0	1	0	38405	0x2b0aa05	[IFEQ_NOJUMP]	19159	[mandreel.js]	19130
38400	1	0	38400	0	0x2b0ac02	[IFEQ_JUMP]	19206	[mandreel.js]	19130
34056	1	0	34056	0	0x31dda0e	[IFNE_JUMP]	60752	[mandreel.js]	60681
34056	0.836152	0.163848	28476	5580	0x31dd996	[IFEQ_JUMP]	60764	[mandreel.js]	60681
34056	0.833333	0.166667	28380	5676	0x31dda01	[IFEQ_JUMP]	60774	[mandreel.js]	60681
25920	1	0	25920	0	0x3805b52	[IFNE_JUMP]	108769	[mandreel.js]	108752
25920	0.0104167	0.989583	270	25650	0x3805b3b	[IFEQ_JUMP]	108774	[mandreel.js]	108752
24692	1	0	24692	0	0x37cbefa	[IFEQ_JUMP]	106491	[mandreel.js]	106315
24692	1	0	24692	0	0x37c0ebe	[IFEQ_JUMP]	106167	[mandreel.js]	106149
24692	1	0	24692	0	0x2a4d5cb	[IFEQ_JUMP]	3611	[mandreel.js]	3584
24692	1	0	24692	0	0x2a4d50d	[IFEQ_JUMP]	3588	[mandreel.js]	3584
24692	0.999757	0.000242994	24686	6	0x2a4d51f	[IFEQ_JUMP]	3594	[mandreel.js]	3584
24692	0.259558	0.740442	6409	18283	0x37cbc19	[IFEQ_JUMP]	106420	[mandreel.js]	106315
24692	0	1	0	24692	0x37cbfea	[IFEQ_NOJUMP]	106510	[mandreel.js]	106315
24692	0	1	0	24692	0x37cbf5c	[IFEQ_NOJUMP]	106498	[mandreel.js]	106315
24692	0	1	0	24692	0x37cb880	[IFEQ_NOJUMP]	106332	[mandreel.js]	106315
24692	0.0535801	0.94642	1323	23369	0x37b1875	[IFEQ_JUMP]	106587	[mandreel.js]	106544
24692	0.0129192	0.987081	319	24373	0x37cbc7e	[IFEQ_JUMP]	106431	[mandreel.js]	106315
24692	0.00546736	0.994533	135	24557	0x37cc00d	[IFEQ_JUMP]	106514	[mandreel.js]	106315
24570	1	0	24570	0	0x2d0f064	[IFNE_JUMP]	11866	[mandreel.js]	11347
24570	1	0	24570	0	0x2d0ee05	[IFNE_JUMP]	11805	[mandreel.js]	11347
24570	0.0002442	0.999756	6	24564	0x2d0f04d	[IFEQ_JUMP]	11874	[mandreel.js]	11347
24570	0.0002442	0.999756	6	24564	0x2d0edee	[IFEQ_JUMP]	11813	[mandreel.js]	11347
24557	0.00700411	0.992996	172	24385	0x37cc073	[IFEQ_JUMP]	106524	[mandreel.js]	106315
24373	1	0	24373	0	0x37cbcc0	[IFEQ_JUMP]	106438	[mandreel.js]	106315
21006	1	0	21006	0	0x2d0fd95	[IFNE_JUMP]	12176	[mandreel.js]	11347
21006	0.000285633	0.999714	6	21000	0x2d0fd7e	[IFEQ_JUMP]	12183	[mandreel.js]	11347
21000	1	0	21000	0	0x2d0fe66	[IFNE_JUMP]	12199	[mandreel.js]	11347
21000	0.000285714	0.999714	6	20994	0x2d0fe4f	[IFEQ_JUMP]	12205	[mandreel.js]	11347
19200	1	0	19200	0	0x36a677f	[IFEQ_JUMP]	95355	[mandreel.js]	95263
19200	0	1	0	19200	0x36a678a	[IFNE_NOJUMP]	95360	[mandreel.js]	95263
7992	1	0	7992	0	0x2d0f3b3	[IFNE_JUMP]	11929	[mandreel.js]	11347
7776	0	1	0	7776	0x2d0f386	[IFEQ_NOJUMP]	11947	[mandreel.js]	11347
7776	0.0277778	0.972222	216	7560	0x30cf3a0	[IFEQ_JUMP]	52305	[mandreel.js]	52292
7776	0.000771605	0.999228	6	7770	0x30cf3e7	[IFEQ_JUMP]	52320	[mandreel.js]	52292
7770	0.972973	0.027027	7560	210	0x30cf3f3	[IFEQ_JUMP]	52321	[mandreel.js]	52292
7764	0.972179	0.0278207	7548	216	0x30cf41a	[IFEQ_JUMP]	52329	[mandreel.js]	52292
7758	0.000773395	0.999227	6	7752	0x30cf44c	[IFEQ_JUMP]	52338	[mandreel.js]	52292
7752	0.44582	0.55418	3456	4296	0x30cf458	[IFEQ_JUMP]	52340	[mandreel.js]	52292
7632	0.437107	0.562893	3336	4296	0x30cf481	[IFEQ_JUMP]	52348	[mandreel.js]	52292
6138	1	0	6138	0	0x36a869d	[IFNE_JUMP]	96022	[mandreel.js]	95898
6138	1	0	6138	0	0x2f62b87	[IFNE_JUMP]	39169	[mandreel.js]	39064
6138	0.990225	0.00977517	6078	60	0x36a8690	[IFEQ_JUMP]	96033	[mandreel.js]	95898
6138	0.990225	0.00977517	6078	60	0x2f62b7a	[IFEQ_JUMP]	39179	[mandreel.js]	39064
5766	1	0	5766	0	0x2f62925	[IFEQ_JUMP]	39114	[mandreel.js]	39064
5766	1	0	5766	0	0x2cfa956	[IFEQ_JUMP]	21101	[mandreel.js]	20948
5766	0.998959	0.00104058	5760	6	0x36a888e	[IFEQ_JUMP]	96086	[mandreel.js]	95898
5766	0.998959	0.00104058	5760	6	0x36a8875	[IFEQ_JUMP]	96085	[mandreel.js]	95898
5766	0.998959	0.00104058	5760	6	0x36a840e	[IFEQ_JUMP]	95962	[mandreel.js]	95898
5766	0.988554	0.0114464	5700	66	0x2f6299a	[IFEQ_JUMP]	39126	[mandreel.js]	39064
5766	0	1	0	5766	0x36a8819	[IFNE_NOJUMP]	96075	[mandreel.js]	95898
5766	0	1	0	5766	0x36a83f2	[IFEQ_NOJUMP]	95958	[mandreel.js]	95898
5766	0	1	0	5766	0x2f6283a	[IFEQ_NOJUMP]	39084	[mandreel.js]	39064
5766	0	1	0	5766	0x2cfa6fd	[IFEQ_NOJUMP]	21050	[mandreel.js]	20948
5766	0	1	0	5766	0x2cfa6b6	[IFEQ_NOJUMP]	21043	[mandreel.js]	20948
5766	0	1	0	5766	0x2cfa3c8	[IFEQ_NOJUMP]	20987	[mandreel.js]	20948
5766	0	1	0	5766	0x2b05303	[IFEQ_NOJUMP]	18032	[mandreel.js]	17829
5766	0	1	0	5766	0x2b04a1c	[IFEQ_NOJUMP]	17885	[mandreel.js]	17829
5766	0.00104058	0.998959	6	5760	0x375f8ef	[IFEQ_JUMP]	99873	[mandreel.js]	99793
5766	0.00104058	0.998959	6	5760	0x375bd93	[IFEQ_JUMP]	99296	[mandreel.js]	99230
5766	0.00104058	0.998959	6	5760	0x375bd5b	[IFEQ_JUMP]	99286	[mandreel.js]	99230
5766	0.00104058	0.998959	6	5760	0x375bd24	[IFEQ_JUMP]	99277	[mandreel.js]	99230
5766	0.00104058	0.998959	6	5760	0x375bc04	[IFEQ_JUMP]	99251	[mandreel.js]	99230
5766	0.00104058	0.998959	6	5760	0x36a8279	[IFEQ_JUMP]	95926	[mandreel.js]	95898
5766	0.00104058	0.998959	6	5760	0x2cfa910	[IFEQ_JUMP]	21094	[mandreel.js]	20948
5760	1	0	5760	0	0x2d12e27	[IFNE_JUMP]	13141	[mandreel.js]	11347
5760	1	0	5760	0	0x2b55945	[IFEQ_JUMP]	10079	[mandreel.js]	10058
5760	0.988542	0.0114583	5694	66	0x36a849e	[IFEQ_JUMP]	95978	[mandreel.js]	95898
5760	0.875	0.125	5040	720	0x2d12e1a	[IFEQ_JUMP]	13158	[mandreel.js]	11347
5760	0	1	0	5760	0x36a82c0	[IFEQ_NOJUMP]	95934	[mandreel.js]	95898
5760	0	1	0	5760	0x36a829e	[IFEQ_NOJUMP]	95930	[mandreel.js]	95898
5760	0	1	0	5760	0x2b55af9	[IFEQ_NOJUMP]	10118	[mandreel.js]	10058
5760	0	1	0	5760	0x2b55a01	[IFEQ_NOJUMP]	10097	[mandreel.js]	10058
5760	0	1	0	5760	0x2b55920	[IFEQ_NOJUMP]	10075	[mandreel.js]	10058
5760	0	1	0	5760	0x2b09e40	[IFEQ_NOJUMP]	18980	[mandreel.js]	18848
5676	1	0	5676	0	0x31dda4c	[IFNE_JUMP]	60733	[mandreel.js]	60681
5676	0	1	0	5676	0x31dd834	[IFEQ_NOJUMP]	60734	[mandreel.js]	60681
4800	1	0	4800	0	0x311d398	[IFNE_JUMP]	54410	[mandreel.js]	54255
4800	0.00104167	0.998958	5	4795	0x311d381	[IFEQ_JUMP]	54418	[mandreel.js]	54255
4300	1	0	4300	0	0x3762501	[IFNE_JUMP]	100825	[mandreel.js]	100804
4300	0.0186047	0.981395	80	4220	0x37624aa	[IFEQ_JUMP]	100828	[mandreel.js]	100804
4296	0.972067	0.027933	4176	120	0x30cf48d	[IFEQ_JUMP]	52350	[mandreel.js]	52292
4296	0.972067	0.027933	4176	120	0x30cf464	[IFEQ_JUMP]	52342	[mandreel.js]	52292
4220	0.36019	0.63981	1520	2700	0x37624cd	[IFEQ_JUMP]	100832	[mandreel.js]	100804
3300	1	0	3300	0	0x38b0ee6	[IFNE_JUMP]	115530	[mandreel.js]	115441
3200	1	0	3200	0	0x38b0aa9	[IFEQ_JUMP]	115535	[mandreel.js]	115441
3012	0	1	0	3012	0x30cf5ca	[IFNE_NOJUMP]	52405	[mandreel.js]	52292
3000	0.07	0.93	210	2790	0x30cf596	[IFEQ_JUMP]	52393	[mandreel.js]	52292
2376	0.909091	0.0909091	2160	216	0x30cf506	[IFEQ_JUMP]	52368	[mandreel.js]	52292
1706	1	0	1706	0	0x375eb07	[IFNE_JUMP]	100753	[mandreel.js]	100744
1706	0.721571	0.278429	1231	475	0x375eaba	[IFEQ_JUMP]	100758	[mandreel.js]	100744
1706	0.387456	0.612544	661	1045	0x375eaf0	[IFEQ_JUMP]	100764	[mandreel.js]	100744
1620	1	0	1620	0	0x31dd7b7	[IFNE_JUMP]	60708	[mandreel.js]	60681
1620	0.166667	0.833333	270	1350	0x31dd7a0	[IFEQ_JUMP]	60714	[mandreel.js]	60681
1600	0	1	0	1600	0x3762699	[IFEQ_NOJUMP]	100880	[mandreel.js]	100804
1600	0	1	0	1600	0x3762472	[IFEQ_NOJUMP]	100822	[mandreel.js]	100804
1344	1	0	1344	0	0x3929d28	[IFNE_JUMP]	121005	[mandreel.js]	120953
1344	0.00446429	0.995536	6	1338	0x3929d11	[IFEQ_JUMP]	121010	[mandreel.js]	120953
1280	0.238281	0.761719	305	975	0x2b00d52	[IFEQ_JUMP]	17133	[mandreel.js]	17048
1280	0	1	0	1280	0x2b00cea	[IFEQ_NOJUMP]	17126	[mandreel.js]	17048
1268	0.00946372	0.990536	12	1256	0x37bf1c0	[IFEQ_JUMP]	105943	[mandreel.js]	105925
1256	0.915605	0.0843949	1150	106	0x37b1a7b	[IFEQ_JUMP]	105821	[mandreel.js]	105791
1256	0.245223	0.754777	308	948	0x37bf2d6	[IFEQ_JUMP]	105967	[mandreel.js]	105925
1100	0.909091	0.0909091	1000	100	0x366dbe1	[IFEQ_JUMP]	91993	[mandreel.js]	91805
1100	0	1	0	1100	0x366dc8e	[IFEQ_NOJUMP]	92009	[mandreel.js]	91805
1100	0	1	0	1100	0x366dc07	[IFEQ_NOJUMP]	91996	[mandreel.js]	91805
1100	0	1	0	1100	0x366dbfd	[IFEQ_NOJUMP]	91994	[mandreel.js]	91805
1100	0.0909091	0.909091	100	1000	0x366ddb7	[IFEQ_JUMP]	92047	[mandreel.js]	91805
1000	0	1	0	1000	0x366ddd1	[IFEQ_NOJUMP]	92050	[mandreel.js]	91805
975	0.871795	0.128205	850	125	0x2b00d96	[IFEQ_JUMP]	17137	[mandreel.js]	17048
948	0	1	0	948	0x37bf587	[IFEQ_NOJUMP]	106030	[mandreel.js]	105925
948	0.00632911	0.993671	6	942	0x37bf5c0	[IFEQ_JUMP]	106036	[mandreel.js]	105925
942	0.430998	0.569002	406	536	0x37bf626	[IFEQ_JUMP]	106046	[mandreel.js]	105925
840	0	1	0	840	0x30cf58b	[IFNE_NOJUMP]	52392	[mandreel.js]	52292
834	1	0	834	0	0x29c118c	[IFNE_JUMP]	3905	[mandreel.js]	3897
834	0.956835	0.0431655	798	36	0x29c1149	[IFEQ_JUMP]	3907	[mandreel.js]	3897
800	1	0	800	0	0x38b07ad	[IFNE_JUMP]	115458	[mandreel.js]	115441
800	1	0	800	0	0x38b0734	[IFEQ_JUMP]	115462	[mandreel.js]	115441
800	0.125	0.875	100	700	0x38b0796	[IFEQ_JUMP]	115471	[mandreel.js]	115441
784	0.00765306	0.992347	6	778	0x29b8b03	[IFEQ_JUMP]	3347	[mandreel.js]	3345
720	1	0	720	0	0x2d12e4b	[IFNE_JUMP]	13136	[mandreel.js]	11347
720	0.875	0.125	630	90	0x2d12e3e	[IFEQ_JUMP]	13164	[mandreel.js]	11347
642	1	0	642	0	0x38b40d5	[IFNE_JUMP]	113135	[mandreel.js]	113086
642	0.981308	0.0186916	630	12	0x38b4086	[IFEQ_JUMP]	113137	[mandreel.js]	113086
630	0	1	0	630	0x38b409b	[IFEQ_NOJUMP]	113142	[mandreel.js]	113086
378	1	0	378	0	0x31f2b7c	[IFNE_JUMP]	61308	[mandreel.js]	61241
378	0.904762	0.0952381	342	36	0x31f2b6f	[IFEQ_JUMP]	61321	[mandreel.js]	61241
270	0.977778	0.0222222	264	6	0x3235249	[IFEQ_JUMP]	63486	[mandreel.js]	63468
270	0	1	0	270	0x3805ae5	[IFEQ_NOJUMP]	108765	[mandreel.js]	108752
270	0	1	0	270	0x31dd740	[IFEQ_NOJUMP]	60704	[mandreel.js]	60681
270	0.0444444	0.955556	12	258	0x31dd7f2	[IFEQ_JUMP]	60727	[mandreel.js]	60681
258	1	0	258	0	0x2d12af2	[IFNE_JUMP]	13075	[mandreel.js]	11347
258	0.976744	0.0232558	252	6	0x2d12ae5	[IFEQ_JUMP]	13091	[mandreel.js]	11347
258	0.837209	0.162791	216	42	0x31f293c	[IFEQ_JUMP]	61264	[mandreel.js]	61241
222	1	0	222	0	0x2d0f3d8	[IFNE_JUMP]	11921	[mandreel.js]	11347
216	0.972222	0.0277778	210	6	0x30cf426	[IFEQ_JUMP]	52331	[mandreel.js]	52292
216	0.0277778	0.972222	6	210	0x30cf3b6	[IFEQ_JUMP]	52310	[mandreel.js]	52292
210	0.971429	0.0285714	204	6	0x30cf3fe	[IFEQ_JUMP]	52323	[mandreel.js]	52292
192	1	0	192	0	0x3910371	[IFNE_JUMP]	115781	[mandreel.js]	115696
192	0.96875	0.03125	186	6	0x3910364	[IFEQ_JUMP]	115798	[mandreel.js]	115696
156	1	0	156	0	0x380789e	[IFNE_JUMP]	108868	[mandreel.js]	108787
144	1	0	144	0	0x384126a	[IFNE_JUMP]	110406	[mandreel.js]	110367
144	1	0	144	0	0x38411f5	[IFEQ_JUMP]	110430	[mandreel.js]	110367
144	1	0	144	0	0x3841142	[IFEQ_JUMP]	110408	[mandreel.js]	110367
144	0	1	0	144	0x3841158	[IFEQ_NOJUMP]	110413	[mandreel.js]	110367
144	0.0833333	0.916667	12	132	0x3841248	[IFEQ_JUMP]	110443	[mandreel.js]	110367
138	1	0	138	0	0x37d9076	[IFNE_JUMP]	106926	[mandreel.js]	106898
138	0.956522	0.0434783	132	6	0x37d9069	[IFEQ_JUMP]	106967	[mandreel.js]	106898
125	1	0	125	0	0x2b00e2b	[IFEQ_JUMP]	17146	[mandreel.js]	17048
125	0	1	0	125	0x2b00de7	[IFEQ_NOJUMP]	17142	[mandreel.js]	17048
106	1	0	106	0	0x380884d	[IFEQ_JUMP]	109106	[mandreel.js]	108998
106	0.896226	0.103774	95	11	0x38086bc	[IFEQ_JUMP]	109072	[mandreel.js]	108998
106	0.103774	0.896226	11	95	0x38089bd	[IFEQ_JUMP]	109129	[mandreel.js]	108998
106	0	1	0	106	0x3808a09	[IFEQ_NOJUMP]	109133	[mandreel.js]	108998
106	0	1	0	106	0x38089f0	[IFEQ_NOJUMP]	109132	[mandreel.js]	108998
106	0	1	0	106	0x380856d	[IFEQ_NOJUMP]	109052	[mandreel.js]	108998
106	0	1	0	106	0x37b1d66	[IFEQ_NOJUMP]	105890	[mandreel.js]	105791
106	0	1	0	106	0x37b1d2d	[IFEQ_NOJUMP]	105884	[mandreel.js]	105791
106	0.0566038	0.943396	6	100	0x37b1dcc	[IFEQ_JUMP]	105900	[mandreel.js]	105791
100	1	0	100	0	0x38b0ef1	[CASE_JUMP]	115665	[mandreel.js]	115441
100	1	0	100	0	0x38b0950	[IFEQ_JUMP]	115507	[mandreel.js]	115441
100	1	0	100	0	0x38af3ee	[IFEQ_JUMP]	115406	[mandreel.js]	115386
100	1	0	100	0	0x3867531	[IFEQ_JUMP]	111776	[mandreel.js]	111249
100	1	0	100	0	0x38674d8	[IFEQ_JUMP]	111760	[mandreel.js]	111249
100	1	0	100	0	0x3866204	[IFEQ_JUMP]	111280	[mandreel.js]	111249
100	1	0	100	0	0x376b7c0	[IFEQ_JUMP]	98732	[mandreel.js]	96804
100	1	0	100	0	0x376b2ed	[IFEQ_JUMP]	98621	[mandreel.js]	96804
100	1	0	100	0	0x37654bc	[IFEQ_JUMP]	96873	[mandreel.js]	96804
100	1	0	100	0	0x36af4e7	[IFEQ_JUMP]	94924	[mandreel.js]	93654
100	1	0	100	0	0x36af24a	[IFEQ_JUMP]	94866	[mandreel.js]	93654
100	1	0	100	0	0x36af072	[IFEQ_JUMP]	94822	[mandreel.js]	93654
100	1	0	100	0	0x36aef81	[IFEQ_JUMP]	94799	[mandreel.js]	93654
100	1	0	100	0	0x36aee42	[IFEQ_JUMP]	94770	[mandreel.js]	93654
100	1	0	100	0	0x36ae10b	[IFEQ_JUMP]	94423	[mandreel.js]	93654
100	1	0	100	0	0x36ae053	[IFEQ_JUMP]	94401	[mandreel.js]	93654
100	1	0	100	0	0x36ad74f	[IFEQ_JUMP]	94153	[mandreel.js]	93654
100	1	0	100	0	0x36ad62d	[CASE_JUMP]	94144	[mandreel.js]	93654
100	1	0	100	0	0x36acd98	[IFEQ_JUMP]	93862	[mandreel.js]	93654
100	1	0	100	0	0x36aca77	[IFEQ_JUMP]	93802	[mandreel.js]	93654
100	1	0	100	0	0x36ac9c5	[IFEQ_JUMP]	93787	[mandreel.js]	93654
100	1	0	100	0	0x36ac8a0	[IFEQ_JUMP]	93756	[mandreel.js]	93654
100	1	0	100	0	0x36ac686	[IFEQ_JUMP]	93701	[mandreel.js]	93654
100	1	0	100	0	0x36ab429	[IFEQ_JUMP]	96714	[mandreel.js]	96582
100	1	0	100	0	0x36ab024	[IFEQ_JUMP]	96603	[mandreel.js]	96582
100	1	0	100	0	0x36aabe4	[IFEQ_JUMP]	96497	[mandreel.js]	96304
100	1	0	100	0	0x36aa981	[IFNE_JUMP]	96425	[mandreel.js]	96304
100	1	0	100	0	0x36aa73e	[IFEQ_JUMP]	96396	[mandreel.js]	96304
100	1	0	100	0	0x36aa665	[IFEQ_JUMP]	96378	[mandreel.js]	96304
100	1	0	100	0	0x36aa4dc	[IFEQ_JUMP]	96327	[mandreel.js]	96304
100	1	0	100	0	0x36a6b86	[IFEQ_JUMP]	95473	[mandreel.js]	95263
100	1	0	100	0	0x3671c83	[IFEQ_JUMP]	93638	[mandreel.js]	93337
100	1	0	100	0	0x365c8c8	[IFEQ_JUMP]	95689	[mandreel.js]	95489
100	1	0	100	0	0x365c6c8	[IFEQ_JUMP]	95646	[mandreel.js]	95489
100	1	0	100	0	0x365c63e	[IFEQ_JUMP]	95629	[mandreel.js]	95489
100	1	0	100	0	0x365c35e	[IFEQ_JUMP]	95562	[mandreel.js]	95489
100	1	0	100	0	0x365c0b0	[IFEQ_JUMP]	95514	[mandreel.js]	95489
100	1	0	100	0	0x365b604	[IFEQ_JUMP]	93002	[mandreel.js]	92773
100	1	0	100	0	0x365aed5	[IFEQ_JUMP]	92807	[mandreel.js]	92773
100	1	0	100	0	0x365a320	[IFEQ_JUMP]	93167	[mandreel.js]	93018
100	1	0	100	0	0x365a175	[IFEQ_JUMP]	93119	[mandreel.js]	93018
100	1	0	100	0	0x3659fd0	[IFEQ_JUMP]	93072	[mandreel.js]	93018
100	1	0	100	0	0x3659e31	[IFEQ_JUMP]	93043	[mandreel.js]	93018
100	1	0	100	0	0x3659b1a	[IFEQ_JUMP]	92757	[mandreel.js]	92649
100	1	0	100	0	0x311d5ac	[IFEQ_JUMP]	54477	[mandreel.js]	54255
100	1	0	100	0	0x2f64ccd	[IFEQ_JUMP]	39582	[mandreel.js]	39382
100	1	0	100	0	0x2f64adb	[IFEQ_JUMP]	39536	[mandreel.js]	39382
100	1	0	100	0	0x2f64776	[IFEQ_JUMP]	39460	[mandreel.js]	39382
100	1	0	100	0	0x2e993d7	[IFEQ_JUMP]	36285	[mandreel.js]	36137
100	1	0	100	0	0x2e98ecd	[IFEQ_JUMP]	36169	[mandreel.js]	36137
100	1	0	100	0	0x2e981ab	[IFEQ_JUMP]	36121	[mandreel.js]	35882
100	1	0	100	0	0x2b5f809	[IFEQ_JUMP]	10359	[mandreel.js]	10316
100	1	0	100	0	0x2b05956	[IFEQ_JUMP]	18251	[mandreel.js]	18220
100	1	0	100	0	0x2aaa419	[IFNE_JUMP]	23399	[mandreel.js]	23378
100	1	0	100	0	0x2aaa3f5	[IFNE_JUMP]	23401	[mandreel.js]	23378
100	1	0	100	0	0x2aa08d0	[IFEQ_JUMP]	5435	[mandreel.js]	5408
100	1	0	100	0	0x2aa07e2	[IFEQ_JUMP]	5410	[mandreel.js]	5408
100	1	0	100	0	0x29bf7b1	[IFEQ_JUMP]	1453	[mandreel.js]	1449
100	1	0	100	0	0x29bf7a4	[AND_JUMP]	1453	[mandreel.js]	1449
100	1	0	100	0	0x29bf783	[OR_JUMP]	1451	[mandreel.js]	1449
100	0.95	0.05	95	5	0x38af56b	[IFEQ_JUMP]	115433	[mandreel.js]	115386
100	0.95	0.05	95	5	0x3762a25	[IFEQ_JUMP]	100931	[mandreel.js]	100904
100	0.95	0.05	95	5	0x311d00f	[IFEQ_JUMP]	54320	[mandreel.js]	54255
100	0	1	0	100	0x38b07cd	[IFEQ_NOJUMP]	115481	[mandreel.js]	115441
100	0	1	0	100	0x38675c5	[IFNE_NOJUMP]	111787	[mandreel.js]	111249
100	0	1	0	100	0x376b804	[IFNE_NOJUMP]	98744	[mandreel.js]	96804
100	0	1	0	100	0x376b663	[IFEQ_NOJUMP]	98704	[mandreel.js]	96804
100	0	1	0	100	0x376b64a	[IFEQ_NOJUMP]	98701	[mandreel.js]	96804
100	0	1	0	100	0x376b5e0	[IFNE_NOJUMP]	98692	[mandreel.js]	96804
100	0	1	0	100	0x375a374	[IFEQ_NOJUMP]	98771	[mandreel.js]	98748
100	0	1	0	100	0x36af52b	[IFNE_NOJUMP]	94936	[mandreel.js]	93654
100	0	1	0	100	0x36af38a	[IFEQ_NOJUMP]	94896	[mandreel.js]	93654
100	0	1	0	100	0x36af371	[IFEQ_NOJUMP]	94893	[mandreel.js]	93654
100	0	1	0	100	0x36af179	[IFEQ_NOJUMP]	94847	[mandreel.js]	93654
100	0	1	0	100	0x36af15e	[IFEQ_NOJUMP]	94844	[mandreel.js]	93654
100	0	1	0	100	0x36aee86	[IFNE_NOJUMP]	94782	[mandreel.js]	93654
100	0	1	0	100	0x36aece5	[IFEQ_NOJUMP]	94742	[mandreel.js]	93654
100	0	1	0	100	0x36aeccc	[IFEQ_NOJUMP]	94739	[mandreel.js]	93654
100	0	1	0	100	0x36ae167	[IFEQ_NOJUMP]	94432	[mandreel.js]	93654
100	0	1	0	100	0x36ae0ef	[IFEQ_NOJUMP]	94420	[mandreel.js]	93654
100	0	1	0	100	0x36ae097	[IFNE_NOJUMP]	94413	[mandreel.js]	93654
100	0	1	0	100	0x36adef6	[IFEQ_NOJUMP]	94373	[mandreel.js]	93654
100	0	1	0	100	0x36adedd	[IFEQ_NOJUMP]	94370	[mandreel.js]	93654
100	0	1	0	100	0x36ade73	[IFNE_NOJUMP]	94361	[mandreel.js]	93654
100	0	1	0	100	0x36ad626	[CASE_NOJUMP]	94136	[mandreel.js]	93654
100	0	1	0	100	0x36ad61f	[CASE_NOJUMP]	94128	[mandreel.js]	93654
100	0	1	0	100	0x36acf10	[IFNE_NOJUMP]	93906	[mandreel.js]	93654
100	0	1	0	100	0x36ac9aa	[IFNE_NOJUMP]	93785	[mandreel.js]	93654
100	0	1	0	100	0x36ab46d	[IFNE_NOJUMP]	96726	[mandreel.js]	96582
100	0	1	0	100	0x36ab2cc	[IFEQ_NOJUMP]	96686	[mandreel.js]	96582
100	0	1	0	100	0x36ab2b3	[IFEQ_NOJUMP]	96683	[mandreel.js]	96582
100	0	1	0	100	0x36aac28	[IFNE_NOJUMP]	96509	[mandreel.js]	96304
100	0	1	0	100	0x36aaa87	[IFEQ_NOJUMP]	96469	[mandreel.js]	96304
100	0	1	0	100	0x36aaa6e	[IFEQ_NOJUMP]	96466	[mandreel.js]	96304
100	0	1	0	100	0x36aa96a	[IFEQ_NOJUMP]	96438	[mandreel.js]	96304
100	0	1	0	100	0x36aa86b	[IFEQ_NOJUMP]	96419	[mandreel.js]	96304
100	0	1	0	100	0x36aa057	[IFEQ_NOJUMP]	96750	[mandreel.js]	96730
100	0	1	0	100	0x36a6bca	[IFNE_NOJUMP]	95485	[mandreel.js]	95263
100	0	1	0	100	0x36a6a29	[IFEQ_NOJUMP]	95445	[mandreel.js]	95263
100	0	1	0	100	0x36a6a10	[IFEQ_NOJUMP]	95442	[mandreel.js]	95263
100	0	1	0	100	0x36a64f1	[IFEQ_NOJUMP]	95287	[mandreel.js]	95263
100	0	1	0	100	0x3671cc7	[IFNE_NOJUMP]	93650	[mandreel.js]	93337
100	0	1	0	100	0x3671b26	[IFEQ_NOJUMP]	93610	[mandreel.js]	93337
100	0	1	0	100	0x3671b0d	[IFEQ_NOJUMP]	93607	[mandreel.js]	93337
100	0	1	0	100	0x3670ff4	[IFEQ_NOJUMP]	93373	[mandreel.js]	93337
100	0	1	0	100	0x365c90c	[IFNE_NOJUMP]	95701	[mandreel.js]	95489
100	0	1	0	100	0x365c76b	[IFEQ_NOJUMP]	95661	[mandreel.js]	95489
100	0	1	0	100	0x365c752	[IFEQ_NOJUMP]	95658	[mandreel.js]	95489
100	0	1	0	100	0x365c682	[IFNE_NOJUMP]	95641	[mandreel.js]	95489
100	0	1	0	100	0x365c4e1	[IFEQ_NOJUMP]	95601	[mandreel.js]	95489
100	0	1	0	100	0x365c4c8	[IFEQ_NOJUMP]	95598	[mandreel.js]	95489
100	0	1	0	100	0x365b648	[IFNE_NOJUMP]	93014	[mandreel.js]	92773
100	0	1	0	100	0x365b4a7	[IFEQ_NOJUMP]	92974	[mandreel.js]	92773
100	0	1	0	100	0x365b48e	[IFEQ_NOJUMP]	92971	[mandreel.js]	92773
100	0	1	0	100	0x365a498	[IFNE_NOJUMP]	93211	[mandreel.js]	93018
100	0	1	0	100	0x365a2ed	[IFNE_NOJUMP]	93163	[mandreel.js]	93018
100	0	1	0	100	0x3659b5e	[IFNE_NOJUMP]	92769	[mandreel.js]	92649
100	0	1	0	100	0x36599bd	[IFEQ_NOJUMP]	92729	[mandreel.js]	92649
100	0	1	0	100	0x36599a4	[IFEQ_NOJUMP]	92726	[mandreel.js]	92649
100	0	1	0	100	0x3659749	[IFEQ_NOJUMP]	92671	[mandreel.js]	92649
100	0	1	0	100	0x36542cb	[IFEQ_NOJUMP]	91510	[mandreel.js]	91497
100	0	1	0	100	0x311d9d6	[IFNE_NOJUMP]	54593	[mandreel.js]	54255
100	0	1	0	100	0x311d3c2	[IFEQ_NOJUMP]	54431	[mandreel.js]	54255
100	0	1	0	100	0x311d002	[IFEQ_NOJUMP]	54318	[mandreel.js]	54255
100	0	1	0	100	0x311b1f9	[IFEQ_NOJUMP]	54033	[mandreel.js]	54013
100	0	1	0	100	0x2f64d11	[IFNE_NOJUMP]	39594	[mandreel.js]	39382
100	0	1	0	100	0x2f64b70	[IFEQ_NOJUMP]	39554	[mandreel.js]	39382
100	0	1	0	100	0x2f64b57	[IFEQ_NOJUMP]	39551	[mandreel.js]	39382
100	0	1	0	100	0x2f64b0d	[IFNE_NOJUMP]	39545	[mandreel.js]	39382
100	0	1	0	100	0x2f64970	[IFEQ_NOJUMP]	39507	[mandreel.js]	39382
100	0	1	0	100	0x2f64957	[IFEQ_NOJUMP]	39504	[mandreel.js]	39382
100	0	1	0	100	0x2f647fa	[IFEQ_NOJUMP]	39477	[mandreel.js]	39382
100	0	1	0	100	0x2f647ba	[IFNE_NOJUMP]	39472	[mandreel.js]	39382
100	0	1	0	100	0x2f64619	[IFEQ_NOJUMP]	39432	[mandreel.js]	39382
100	0	1	0	100	0x2f64600	[IFEQ_NOJUMP]	39429	[mandreel.js]	39382
100	0	1	0	100	0x2e99bd5	[IFNE_NOJUMP]	36484	[mandreel.js]	36137
100	0	1	0	100	0x2e9936f	[IFNE_NOJUMP]	36277	[mandreel.js]	36137
100	0	1	0	100	0x2e981ef	[IFNE_NOJUMP]	36133	[mandreel.js]	35882
100	0	1	0	100	0x2e9804e	[IFEQ_NOJUMP]	36093	[mandreel.js]	35882
100	0	1	0	100	0x2e98035	[IFEQ_NOJUMP]	36090	[mandreel.js]	35882
100	0	1	0	100	0x2e978e5	[IFEQ_NOJUMP]	35911	[mandreel.js]	35882
100	0	1	0	100	0x2b5f703	[IFEQ_NOJUMP]	10339	[mandreel.js]	10316
100	0	1	0	100	0x29bf794	[IFEQ_NOJUMP]	1451	[mandreel.js]	1449
100	0	1	0	100	0x29bb813	[IFEQ_NOJUMP]	1789	[mandreel.js]	1782
100	0	1	0	100	0x29bb7fc	[IFEQ_NOJUMP]	1786	[mandreel.js]	1782
100	0	1	0	100	0x29b6ed9	[IFNE_NOJUMP]	98	[mandreel.js]	97
95	0	1	0	95	0x311d39e	[IFNE_NOJUMP]	54428	[mandreel.js]	54255
90	1	0	90	0	0x2d12edf	[IFNE_JUMP]	13132	[mandreel.js]	11347
90	0.933333	0.0666667	84	6	0x2d12ec8	[IFEQ_JUMP]	13181	[mandreel.js]	11347
66	0.909091	0.0909091	60	6	0x36a84b6	[IFEQ_JUMP]	95982	[mandreel.js]	95898
66	0.909091	0.0909091	60	6	0x2f629b2	[IFEQ_JUMP]	39130	[mandreel.js]	39064
66	0	1	0	66	0x36a8563	[IFEQ_NOJUMP]	95998	[mandreel.js]	95898
66	0	1	0	66	0x36a84dc	[IFEQ_NOJUMP]	95985	[mandreel.js]	95898
66	0	1	0	66	0x36a84d2	[IFEQ_NOJUMP]	95983	[mandreel.js]	95898
66	0	1	0	66	0x2f62a5f	[IFEQ_NOJUMP]	39146	[mandreel.js]	39064
66	0	1	0	66	0x2f629d8	[IFEQ_NOJUMP]	39133	[mandreel.js]	39064
66	0	1	0	66	0x2f629ce	[IFEQ_NOJUMP]	39131	[mandreel.js]	39064
66	0.0909091	0.909091	6	60	0x36a86b4	[IFEQ_JUMP]	96040	[mandreel.js]	95898
66	0.0909091	0.909091	6	60	0x2f62b97	[IFEQ_JUMP]	39186	[mandreel.js]	39064
60	0	1	0	60	0x36a86cf	[IFEQ_NOJUMP]	96043	[mandreel.js]	95898
60	0	1	0	60	0x2f62bb1	[IFEQ_NOJUMP]	39189	[mandreel.js]	39064
42	0.857143	0.142857	36	6	0x31f2954	[IFEQ_JUMP]	61268	[mandreel.js]	61241
42	0.142857	0.857143	6	36	0x31f2b92	[IFEQ_JUMP]	61328	[mandreel.js]	61241
42	0	1	0	42	0x31f2a01	[IFEQ_NOJUMP]	61284	[mandreel.js]	61241
42	0	1	0	42	0x31f297a	[IFEQ_NOJUMP]	61271	[mandreel.js]	61241
42	0	1	0	42	0x31f2970	[IFEQ_NOJUMP]	61269	[mandreel.js]	61241
36	1	0	36	0	0x3841900	[IFNE_JUMP]	110619	[mandreel.js]	110367
36	1	0	36	0	0x29c1126	[IFEQ_JUMP]	3901	[mandreel.js]	3897
36	0.666667	0.333333	24	12	0x38418a1	[IFEQ_JUMP]	110621	[mandreel.js]	110367
36	0	1	0	36	0x31f2bac	[IFEQ_NOJUMP]	61331	[mandreel.js]	61241
24	1	0	24	0	0x38b68eb	[IFNE_JUMP]	113125	[mandreel.js]	113086
24	1	0	24	0	0x38418bc	[IFEQ_JUMP]	110627	[mandreel.js]	110367
24	1	0	24	0	0x37e27b6	[CASE_JUMP]	107656	[mandreel.js]	107554
24	1	0	24	0	0x37e27ab	[IFNE_JUMP]	107574	[mandreel.js]	107554
24	1	0	24	0	0x37e2631	[IFEQ_JUMP]	107584	[mandreel.js]	107554
24	1	0	24	0	0x37e260a	[IFEQ_JUMP]	107577	[mandreel.js]	107554
24	0.5	0.5	12	12	0x38b4049	[IFEQ_JUMP]	113127	[mandreel.js]	113086
24	0	1	0	24	0x38418e2	[IFEQ_NOJUMP]	110634	[mandreel.js]	110367
18	1	0	18	0	0x2d0ffa7	[IFNE_JUMP]	12215	[mandreel.js]	11347
18	0.333333	0.666667	6	12	0x2d0ff90	[IFEQ_JUMP]	12239	[mandreel.js]	11347
18	0	1	0	18	0x2d0feda	[IFEQ_NOJUMP]	12221	[mandreel.js]	11347
12	1	0	12	0	0x3865cb9	[IFEQ_JUMP]	114625	[mandreel.js]	114579
12	1	0	12	0	0x3865ba4	[IFEQ_JUMP]	114603	[mandreel.js]	114579
12	1	0	12	0	0x3841356	[IFEQ_JUMP]	110475	[mandreel.js]	110367
12	1	0	12	0	0x38410c0	[IFEQ_JUMP]	110396	[mandreel.js]	110367
12	1	0	12	0	0x38078d3	[IFEQ_JUMP]	108898	[mandreel.js]	108787
12	1	0	12	0	0x3807675	[IFEQ_JUMP]	108817	[mandreel.js]	108787
12	1	0	12	0	0x3807635	[IFEQ_JUMP]	108809	[mandreel.js]	108787
12	1	0	12	0	0x3763fe1	[IFNE_JUMP]	101022	[mandreel.js]	100960
12	1	0	12	0	0x2d0f94a	[IFNE_JUMP]	12075	[mandreel.js]	11347
12	1	0	12	0	0x2d0b12b	[IFNE_JUMP]	25039	[mandreel.js]	24787
12	1	0	12	0	0x2d0b0ae	[IFNE_JUMP]	25024	[mandreel.js]	24787
12	1	0	12	0	0x2d0b012	[IFNE_JUMP]	25004	[mandreel.js]	24787
12	1	0	12	0	0x2d0ac74	[IFNE_JUMP]	24897	[mandreel.js]	24787
12	0.5	0.5	6	6	0x38aee48	[IFEQ_NOJUMP]	115320	[mandreel.js]	115299
12	0.5	0.5	6	6	0x380790b	[IFEQ_JUMP]	108906	[mandreel.js]	108787
12	0.5	0.5	6	6	0x3763fca	[IFEQ_JUMP]	101028	[mandreel.js]	100960
12	0.5	0.5	6	6	0x2d0f933	[IFEQ_JUMP]	12088	[mandreel.js]	11347
12	0.5	0.5	6	6	0x2d0b11e	[IFEQ_JUMP]	25046	[mandreel.js]	24787
12	0.5	0.5	6	6	0x2d0b0a1	[IFEQ_JUMP]	25031	[mandreel.js]	24787
12	0.5	0.5	6	6	0x2d0b005	[IFEQ_JUMP]	25011	[mandreel.js]	24787
12	0.5	0.5	6	6	0x2d0ac67	[IFEQ_JUMP]	24904	[mandreel.js]	24787
12	0	1	0	12	0x38b4236	[IFEQ_NOJUMP]	113189	[mandreel.js]	113086
12	0	1	0	12	0x38b40e4	[IFEQ_NOJUMP]	113154	[mandreel.js]	113086
12	0	1	0	12	0x3865c96	[IFEQ_NOJUMP]	114623	[mandreel.js]	114579
12	0	1	0	12	0x3865c8a	[IFEQ_NOJUMP]	114621	[mandreel.js]	114579
12	0	1	0	12	0x3865c7f	[IFEQ_NOJUMP]	114619	[mandreel.js]	114579
12	0	1	0	12	0x3865c74	[IFEQ_NOJUMP]	114617	[mandreel.js]	114579
12	0	1	0	12	0x38419b8	[IFEQ_NOJUMP]	110662	[mandreel.js]	110367
12	0	1	0	12	0x3841936	[IFEQ_NOJUMP]	110648	[mandreel.js]	110367
12	0	1	0	12	0x3841300	[IFEQ_NOJUMP]	110467	[mandreel.js]	110367
12	0	1	0	12	0x38410fe	[IFEQ_NOJUMP]	110400	[mandreel.js]	110367
12	0	1	0	12	0x3807900	[IFEQ_NOJUMP]	108905	[mandreel.js]	108787
12	0	1	0	12	0x37e1e0c	[IFEQ_NOJUMP]	108957	[mandreel.js]	108935
12	0	1	0	12	0x37e1db7	[IFEQ_NOJUMP]	108952	[mandreel.js]	108935
12	0	1	0	12	0x31dda52	[IFNE_NOJUMP]	60791	[mandreel.js]	60681
12	0	1	0	12	0x2a5737d	[IFEQ_NOJUMP]	4133	[mandreel.js]	4106
6	1	0	6	0	0x39610d2	[IFEQ_JUMP]	122858	[mandreel.js]	122801
6	1	0	6	0	0x3960fbc	[IFEQ_JUMP]	122839	[mandreel.js]	122801
6	1	0	6	0	0x3960f6a	[IFEQ_JUMP]	122828	[mandreel.js]	122801
6	1	0	6	0	0x3960f2f	[IFEQ_JUMP]	122821	[mandreel.js]	122801
6	1	0	6	0	0x39121b4	[IFEQ_JUMP]	116820	[mandreel.js]	115696
6	1	0	6	0	0x391092e	[IFEQ_JUMP]	115927	[mandreel.js]	115696
6	1	0	6	0	0x3910264	[IFEQ_JUMP]	115772	[mandreel.js]	115696
6	1	0	6	0	0x3807992	[IFNE_JUMP]	108913	[mandreel.js]	108787
6	1	0	6	0	0x380797b	[IFEQ_JUMP]	108920	[mandreel.js]	108787
6	1	0	6	0	0x37dd93f	[IFEQ_JUMP]	107360	[mandreel.js]	107267
6	1	0	6	0	0x37dd8fd	[IFNE_JUMP]	107322	[mandreel.js]	107267
6	1	0	6	0	0x37dd8c1	[IFEQ_JUMP]	107340	[mandreel.js]	107267
6	1	0	6	0	0x37dd879	[IFEQ_JUMP]	107331	[mandreel.js]	107267
6	1	0	6	0	0x37dd742	[IFEQ_JUMP]	107288	[mandreel.js]	107267
6	1	0	6	0	0x3763e8c	[IFEQ_JUMP]	100988	[mandreel.js]	100960
6	1	0	6	0	0x36a90ec	[IFEQ_JUMP]	96121	[mandreel.js]	96096
6	1	0	6	0	0x31f602a	[IFEQ_JUMP]	61393	[mandreel.js]	61370
6	1	0	6	0	0x31f22c5	[IFEQ_JUMP]	61560	[mandreel.js]	61510
6	1	0	6	0	0x2d11260	[IFEQ_JUMP]	12615	[mandreel.js]	11347
6	1	0	6	0	0x2d0fa2d	[IFEQ_JUMP]	12112	[mandreel.js]	11347
6	1	0	6	0	0x2d0f5a7	[IFEQ_JUMP]	12005	[mandreel.js]	11347
6	1	0	6	0	0x2d0f3e3	[CASE_JUMP]	11966	[mandreel.js]	11347
6	1	0	6	0	0x2d0b13c	[IFEQ_JUMP]	25054	[mandreel.js]	24787
6	1	0	6	0	0x2d0aebb	[IFEQ_JUMP]	24976	[mandreel.js]	24787
6	1	0	6	0	0x2d0ab27	[IFEQ_JUMP]	24872	[mandreel.js]	24787
6	0	1	0	6	0x3960f03	[IFEQ_NOJUMP]	122817	[mandreel.js]	122801
6	0	1	0	6	0x3913d69	[IFEQ_NOJUMP]	117768	[mandreel.js]	115696
6	0	1	0	6	0x3910448	[IFEQ_NOJUMP]	115820	[mandreel.js]	115696
6	0	1	0	6	0x39101ec	[IFEQ_NOJUMP]	115760	[mandreel.js]	115696
6	0	1	0	6	0x3807998	[IFNE_NOJUMP]	108930	[mandreel.js]	108787
6	0	1	0	6	0x3807915	[IFEQ_NOJUMP]	108908	[mandreel.js]	108787
6	0	1	0	6	0x37dd9ae	[IFNE_NOJUMP]	107381	[mandreel.js]	107267
6	0	1	0	6	0x37dd91c	[IFEQ_NOJUMP]	107356	[mandreel.js]	107267
6	0	1	0	6	0x37dd8f0	[IFEQ_NOJUMP]	107347	[mandreel.js]	107267
6	0	1	0	6	0x37dd802	[IFNE_NOJUMP]	107321	[mandreel.js]	107267
6	0	1	0	6	0x37dd725	[IFEQ_NOJUMP]	107284	[mandreel.js]	107267
6	0	1	0	6	0x3763ff8	[IFEQ_NOJUMP]	101037	[mandreel.js]	100960
6	0	1	0	6	0x3763ee5	[IFEQ_NOJUMP]	100997	[mandreel.js]	100960
6	0	1	0	6	0x31f643b	[IFNE_NOJUMP]	61505	[mandreel.js]	61370
6	0	1	0	6	0x31f601d	[IFEQ_NOJUMP]	61391	[mandreel.js]	61370
6	0	1	0	6	0x2f62b8d	[IFNE_NOJUMP]	39185	[mandreel.js]	39064
6	0	1	0	6	0x2d128a4	[IFEQ_NOJUMP]	13045	[mandreel.js]	11347
6	0	1	0	6	0x2d12851	[IFEQ_NOJUMP]	13037	[mandreel.js]	11347
6	0	1	0	6	0x2d11bf8	[IFEQ_NOJUMP]	12791	[mandreel.js]	11347
6	0	1	0	6	0x2d113e1	[IFEQ_NOJUMP]	12652	[mandreel.js]	11347
6	0	1	0	6	0x2d113c0	[IFEQ_NOJUMP]	12648	[mandreel.js]	11347
6	0	1	0	6	0x2d11256	[IFNE_NOJUMP]	12614	[mandreel.js]	11347
6	0	1	0	6	0x2d11128	[IFEQ_NOJUMP]	12575	[mandreel.js]	11347
6	0	1	0	6	0x2d110c0	[IFEQ_NOJUMP]	12565	[mandreel.js]	11347
6	0	1	0	6	0x2d110b6	[IFEQ_NOJUMP]	12563	[mandreel.js]	11347
6	0	1	0	6	0x2d1109a	[IFEQ_NOJUMP]	12562	[mandreel.js]	11347
6	0	1	0	6	0x2d11087	[IFEQ_NOJUMP]	12559	[mandreel.js]	11347
6	0	1	0	6	0x2d10f1b	[IFEQ_NOJUMP]	12530	[mandreel.js]	11347
6	0	1	0	6	0x2d10c20	[IFEQ_NOJUMP]	12470	[mandreel.js]	11347
6	0	1	0	6	0x2d10958	[IFEQ_NOJUMP]	12410	[mandreel.js]	11347
6	0	1	0	6	0x2d0fcc5	[IFEQ_NOJUMP]	12165	[mandreel.js]	11347
6	0	1	0	6	0x2d0f7f4	[IFEQ_NOJUMP]	12060	[mandreel.js]	11347
6	0	1	0	6	0x2d0f6dc	[IFEQ_NOJUMP]	12035	[mandreel.js]	11347
6	0	1	0	6	0x2d0f493	[IFEQ_NOJUMP]	11979	[mandreel.js]	11347
6	0	1	0	6	0x2d0ef49	[IFEQ_NOJUMP]	11849	[mandreel.js]	11347
6	0	1	0	6	0x2d0ee81	[IFEQ_NOJUMP]	11830	[mandreel.js]	11347
6	0	1	0	6	0x2d0ece9	[IFEQ_NOJUMP]	11788	[mandreel.js]	11347
6	0	1	0	6	0x2d0ec20	[IFEQ_NOJUMP]	11769	[mandreel.js]	11347
6	0	1	0	6	0x2d0eb45	[IFEQ_NOJUMP]	11749	[mandreel.js]	11347
6	0	1	0	6	0x2d0ea56	[IFEQ_NOJUMP]	11727	[mandreel.js]	11347
6	0	1	0	6	0x2d0e942	[IFEQ_NOJUMP]	11703	[mandreel.js]	11347
6	0	1	0	6	0x2d0e839	[IFEQ_NOJUMP]	11679	[mandreel.js]	11347
6	0	1	0	6	0x2d0e74c	[IFEQ_NOJUMP]	11657	[mandreel.js]	11347
6	0	1	0	6	0x2d0e65f	[IFEQ_NOJUMP]	11635	[mandreel.js]	11347
6	0	1	0	6	0x2d0e572	[IFEQ_NOJUMP]	11613	[mandreel.js]	11347
6	0	1	0	6	0x2d0e485	[IFEQ_NOJUMP]	11591	[mandreel.js]	11347
6	0	1	0	6	0x2d0e398	[IFEQ_NOJUMP]	11569	[mandreel.js]	11347
6	0	1	0	6	0x2d0e2ab	[IFEQ_NOJUMP]	11547	[mandreel.js]	11347
6	0	1	0	6	0x2d0e1be	[IFEQ_NOJUMP]	11525	[mandreel.js]	11347
6	0	1	0	6	0x2d0e0d1	[IFEQ_NOJUMP]	11503	[mandreel.js]	11347
6	0	1	0	6	0x2d0dfe4	[IFEQ_NOJUMP]	11481	[mandreel.js]	11347
6	0	1	0	6	0x2d0de97	[IFEQ_NOJUMP]	11452	[mandreel.js]	11347
6	0	1	0	6	0x2d0ddb5	[IFEQ_NOJUMP]	11430	[mandreel.js]	11347
6	0	1	0	6	0x2d0dcac	[IFEQ_NOJUMP]	11406	[mandreel.js]	11347
6	0	1	0	6	0x2d0b381	[IFNE_NOJUMP]	25112	[mandreel.js]	24787
6	0	1	0	6	0x2d0b0b9	[IFEQ_NOJUMP]	25036	[mandreel.js]	24787
6	0	1	0	6	0x2d0b03c	[IFEQ_NOJUMP]	25021	[mandreel.js]	24787
6	0	1	0	6	0x2d0ad6b	[IFEQ_NOJUMP]	24934	[mandreel.js]	24787
6	0	1	0	6	0x2d0ace4	[IFEQ_NOJUMP]	24921	[mandreel.js]	24787
6	0	1	0	6	0x2d0acda	[IFEQ_NOJUMP]	24919	[mandreel.js]	24787
6	0	1	0	6	0x2d0acbd	[IFEQ_NOJUMP]	24916	[mandreel.js]	24787
6	0	1	0	6	0x2d0acb0	[IFEQ_NOJUMP]	24914	[mandreel.js]	24787
6	0	1	0	6	0x2d0a9d7	[IFEQ_NOJUMP]	24830	[mandreel.js]	24787
6	0	1	0	6	0x2d0a950	[IFEQ_NOJUMP]	24817	[mandreel.js]	24787
6	0	1	0	6	0x2d0a946	[IFEQ_NOJUMP]	24815	[mandreel.js]	24787
6	0	1	0	6	0x2d0a929	[IFEQ_NOJUMP]	24812	[mandreel.js]	24787
6	0	1	0	6	0x2d0a913	[IFEQ_NOJUMP]	24809	[mandreel.js]	24787
6	0	1	0	6	0x2d065f5	[IFEQ_NOJUMP]	25158	[mandreel.js]	25116
6	0	1	0	6	0x2b0a509	[IFNE_NOJUMP]	19119	[mandreel.js]	18848
5	1	0	5	0	0x36ae4a2	[IFEQ_JUMP]	94521	[mandreel.js]	93654
5	1	0	5	0	0x36ae3f0	[IFEQ_JUMP]	94501	[mandreel.js]	93654
5	1	0	5	0	0x311d22b	[IFEQ_JUMP]	54382	[mandreel.js]	54255
5	1	0	5	0	0x2b0aae0	[IFEQ_JUMP]	19179	[mandreel.js]	19130
5	1	0	5	0	0x29b6008	[IFEQ_JUMP]	210	[mandreel.js]	205
5	0	1	0	5	0x36ae373	[IFEQ_NOJUMP]	94485	[mandreel.js]	93654
5	0	1	0	5	0x36ae2ec	[IFEQ_NOJUMP]	94472	[mandreel.js]	93654
5	0	1	0	5	0x36ae2e2	[IFEQ_NOJUMP]	94470	[mandreel.js]	93654
5	0	1	0	5	0x36ae2c6	[IFEQ_NOJUMP]	94469	[mandreel.js]	93654
5	0	1	0	5	0x311d0bd	[IFEQ_NOJUMP]	54338	[mandreel.js]	54255
5	0	1	0	5	0x311d036	[IFEQ_NOJUMP]	54325	[mandreel.js]	54255
5	0	1	0	5	0x311d02c	[IFEQ_NOJUMP]	54323	[mandreel.js]	54255
5	0	1	0	5	0x2b0afa8	[IFNE_NOJUMP]	19283	[mandreel.js]	19130
4	1	0	4	0	0x29b6bec	[IFEQ_JUMP]	280	[mandreel.js]	240
4	1	0	4	0	0x29b6b8b	[IFEQ_JUMP]	259	[mandreel.js]	240
4	1	0	4	0	0x29b6b7d	[IFEQ_JUMP]	253	[mandreel.js]	240
4	1	0	4	0	0x29b6b6f	[IFEQ_JUMP]	248	[mandreel.js]	240
4	0.75	0.25	3	1	0x2a1d911	[IFEQ_JUMP]	143	[mandreel.js]	142
4	0.75	0.25	3	1	0x29b6ba7	[IFEQ_JUMP]	271	[mandreel.js]	240
4	0.75	0.25	3	1	0x29b6b99	[IFEQ_JUMP]	264	[mandreel.js]	240
4	0.75	0.25	3	1	0x29b6b61	[IFEQ_JUMP]	243	[mandreel.js]	240
3	1	0	3	0	0x2a1d92f	[IFEQ_JUMP]	145	[mandreel.js]	142
1	1	0	1	0	0x5b6af84	[IFEQ_JUMP]	5481	[mandreel.js]	1
1	1	0	1	0	0x5b6adb4	[IFEQ_JUMP]	3891	[mandreel.js]	1
1	1	0	1	0	0x5b6aaf9	[IFEQ_JUMP]	2753	[mandreel.js]	1
1	1	0	1	0	0x5b6a823	[IFEQ_JUMP]	330	[mandreel.js]	1
1	1	0	1	0	0x2a4e7f4	[IFEQ_JUMP]	1382	[mandreel.js]	1169
1	1	0	1	0	0x2a4e7a8	[IFEQ_JUMP]	1371	[mandreel.js]	1169
1	1	0	1	0	0x2a4e36d	[IFEQ_JUMP]	1282	[mandreel.js]	1169
1	1	0	1	0	0x2a4e2ff	[IFEQ_JUMP]	1266	[mandreel.js]	1169
1	1	0	1	0	0x2a4e2ac	[IFEQ_JUMP]	1256	[mandreel.js]	1169
1	1	0	1	0	0x2a4e1fe	[IFEQ_JUMP]	1230	[mandreel.js]	1169
1	1	0	1	0	0x2a4e1be	[IFEQ_JUMP]	1224	[mandreel.js]	1169
1	1	0	1	0	0x2a4e171	[IFEQ_JUMP]	1216	[mandreel.js]	1169
1	1	0	1	0	0x2a4e114	[IFEQ_JUMP]	1209	[mandreel.js]	1169
1	1	0	1	0	0x2a4e0d7	[IFEQ_JUMP]	1202	[mandreel.js]	1169
1	1	0	1	0	0x2a4e07f	[OR_JUMP]	1196	[mandreel.js]	1169
1	1	0	1	0	0x2a4e04a	[IFEQ_JUMP]	1190	[mandreel.js]	1169
1	1	0	1	0	0x2a4e006	[AND_JUMP]	1190	[mandreel.js]	1169
1	1	0	1	0	0x2a4dfe3	[IFEQ_JUMP]	1182	[mandreel.js]	1169
1	1	0	1	0	0x2a4dfbc	[IFEQ_JUMP]	1179	[mandreel.js]	1169
1	1	0	1	0	0x2a4a890	[IFEQ_JUMP]	1155	[mandreel.js]	1094
1	1	0	1	0	0x2a4a82d	[IFEQ_JUMP]	1149	[mandreel.js]	1094
1	1	0	1	0	0x2a4a81c	[AND_JUMP]	1149	[mandreel.js]	1094
1	1	0	1	0	0x2a4a7ef	[IFEQ_JUMP]	1145	[mandreel.js]	1094
1	1	0	1	0	0x2a4a799	[IFEQ_JUMP]	1138	[mandreel.js]	1094
1	1	0	1	0	0x2a4a778	[IFEQ_JUMP]	1134	[mandreel.js]	1094
1	1	0	1	0	0x2a4a725	[IFEQ_JUMP]	1128	[mandreel.js]	1094
1	1	0	1	0	0x2a4a6f3	[IFEQ_JUMP]	1126	[mandreel.js]	1094
1	1	0	1	0	0x2a4a6d1	[AND_JUMP]	1126	[mandreel.js]	1094
1	1	0	1	0	0x2a4a69f	[IFEQ_JUMP]	1124	[mandreel.js]	1094
1	1	0	1	0	0x2a4a66c	[AND_JUMP]	1124	[mandreel.js]	1094
1	1	0	1	0	0x2a4a61e	[IFEQ_JUMP]	1118	[mandreel.js]	1094
1	1	0	1	0	0x2a4a56c	[IFEQ_JUMP]	1097	[mandreel.js]	1094
1	1	0	1	0	0x2a4a545	[IFEQ_JUMP]	1096	[mandreel.js]	1094
1	1	0	1	0	0x29dbb7e	[IFEQ_JUMP]	1424	[mandreel.js]	1419
1	1	0	1	0	0x29dba33	[IFEQ_JUMP]	1404	[mandreel.js]	1402
1	1	0	1	0	0x29bf9aa	[IFEQ_JUMP]	931	[mandreel.js]	917
1	1	0	1	0	0x29bf92d	[IFEQ_JUMP]	919	[mandreel.js]	917
1	1	0	1	0	0x29bf563	[OR_JUMP]	1433	[mandreel.js]	1431
1	1	0	1	0	0x29bef83	[IFEQ_JUMP]	945	[mandreel.js]	943
1	1	0	1	0	0x29b94f5	[IFEQ_JUMP]	42	[mandreel.js]	37
1	1	0	1	0	0x29b6bcb	[IFEQ_JUMP]	275	[mandreel.js]	240
1	1	0	1	0	0x29a32fd	[IFEQ_JUMP]	1091	[mandreel.js]	1084
1	1	0	1	0	0x29a32cb	[IFEQ_JUMP]	1088	[mandreel.js]	1084
1	0	1	0	1	0x5b6b13a	[OR_NOJUMP]	7387	[mandreel.js]	1
1	0	1	0	1	0x5b6abea	[IFEQ_NOJUMP]	2907	[mandreel.js]	1
1	0	1	0	1	0x5b6aa2c	[OR_NOJUMP]	2233	[mandreel.js]	1
1	0	1	0	1	0x5b6aa1c	[OR_NOJUMP]	2233	[mandreel.js]	1
1	0	1	0	1	0x5b6a858	[IFEQ_NOJUMP]	336	[mandreel.js]	1
1	0	1	0	1	0x5b6a6ac	[IFEQ_NOJUMP]	176	[mandreel.js]	1
1	0	1	0	1	0x2a576a3	[OR_NOJUMP]	2672	[mandreel.js]	2670
1	0	1	0	1	0x2a4e33b	[IFEQ_NOJUMP]	1276	[mandreel.js]	1169
1	0	1	0	1	0x2a4e29c	[IFEQ_NOJUMP]	1245	[mandreel.js]	1169
1	0	1	0	1	0x2a4e268	[IFEQ_NOJUMP]	1240	[mandreel.js]	1169
1	0	1	0	1	0x2a4e235	[IFEQ_NOJUMP]	1235	[mandreel.js]	1169
1	0	1	0	1	0x2a4e0b4	[IFEQ_NOJUMP]	1199	[mandreel.js]	1169
1	0	1	0	1	0x2a4e090	[IFEQ_NOJUMP]	1196	[mandreel.js]	1169
1	0	1	0	1	0x2a4df95	[IFEQ_NOJUMP]	1176	[mandreel.js]	1169
1	0	1	0	1	0x2a4a591	[IFEQ_NOJUMP]	1101	[mandreel.js]	1094
1	0	1	0	1	0x2a4a55a	[AND_NOJUMP]	1097	[mandreel.js]	1094
1	0	1	0	1	0x2a1d9d1	[IFEQ_NOJUMP]	152	[mandreel.js]	151
1	0	1	0	1	0x29dbb5d	[IFEQ_NOJUMP]	1421	[mandreel.js]	1419
1	0	1	0	1	0x29dba58	[IFEQ_NOJUMP]	1411	[mandreel.js]	1402
1	0	1	0	1	0x29bf9f9	[IFEQ_NOJUMP]	936	[mandreel.js]	917
1	0	1	0	1	0x29bf574	[IFEQ_NOJUMP]	1433	[mandreel.js]	1431
1	0	1	0	1	0x29ba12d	[IFEQ_NOJUMP]	46	[run.js.mandreel.js]	45
1	0	1	0	1	0x29b94d6	[AND_NOJUMP]	41	[mandreel.js]	37
1	0	1	0	1	0x29b94c4	[AND_NOJUMP]	40	[mandreel.js]	37
