498870	1	0	498870	0	0x34fcdbb	[IFEQ_JUMP]	27640	[pdfjs.js]	27622
498870	0	1	0	498870	0x34fcdb0	[OR_NOJUMP]	27640	[pdfjs.js]	27622
498870	0	1	0	498870	0x34fcda3	[OR_NOJUMP]	27640	[pdfjs.js]	27622
490865	1	0	490865	0	0x34fcd35	[IFEQ_JUMP]	27632	[pdfjs.js]	27622
479265	1	0	479265	0	0x34fe04f	[IFNE_JUMP]	27783	[pdfjs.js]	27687
382710	0.156633	0.843367	59945	322765	0x333f171	[OR_JUMP]	16931	[pdfjs.js]	16930
322765	0.0510433	0.948957	16475	306290	0x333f180	[OR_JUMP]	16931	[pdfjs.js]	16930
307140	0.0107931	0.989207	3315	303825	0x3388391	[IFEQ_JUMP]	17259	[pdfjs.js]	17228
265900	0.2	0.8	53180	212720	0x2778e8f	[AND_JUMP]	100	[pdfjs.js]	96
264955	0.996509	0.00349116	264030	925	0x33875ad	[IFEQ_JUMP]	16971	[pdfjs.js]	16934
264955	0.945746	0.0542545	250580	14375	0x338758f	[AND_JUMP]	16970	[pdfjs.js]	16934
264955	0.0542545	0.945746	14375	250580	0x3387586	[OR_JUMP]	16970	[pdfjs.js]	16934
264030	0.823637	0.176363	217465	46565	0x33876ef	[IFEQ_JUMP]	16990	[pdfjs.js]	16934
217465	0.0498241	0.950176	10835	206630	0x3387726	[IFEQ_JUMP]	16995	[pdfjs.js]	16934
206630	0.000217781	0.999782	45	206585	0x3387734	[CASE_JUMP]	16997	[pdfjs.js]	16934
206585	0.000217828	0.999782	45	206540	0x338773e	[CASE_JUMP]	17000	[pdfjs.js]	16934
206540	0.000217875	0.999782	45	206495	0x3387748	[CASE_JUMP]	17024	[pdfjs.js]	16934
206495	0.000217923	0.999782	45	206450	0x3387752	[CASE_JUMP]	17025	[pdfjs.js]	16934
206450	0	1	0	206450	0x3387766	[CASE_NOJUMP]	17027	[pdfjs.js]	16934
206450	0	1	0	206450	0x338775c	[CASE_NOJUMP]	17026	[pdfjs.js]	16934
206450	0.00021797	0.999782	45	206405	0x3387770	[CASE_JUMP]	17028	[pdfjs.js]	16934
206405	0.000218018	0.999782	45	206360	0x338777a	[CASE_JUMP]	17029	[pdfjs.js]	16934
206360	0.000218066	0.999782	45	206315	0x3387784	[CASE_JUMP]	17033	[pdfjs.js]	16934
206315	0.000218113	0.999782	45	206270	0x338778e	[CASE_JUMP]	17034	[pdfjs.js]	16934
206270	4.84801e-05	0.999952	10	206260	0x3387798	[CASE_JUMP]	17038	[pdfjs.js]	16934
206260	4.84825e-05	0.999952	10	206250	0x33877ac	[CASE_JUMP]	17040	[pdfjs.js]	16934
206260	0	1	0	206260	0x33877a2	[CASE_NOJUMP]	17039	[pdfjs.js]	16934
206250	0.000218182	0.999782	45	206205	0x33877b6	[CASE_JUMP]	17041	[pdfjs.js]	16934
206205	0	1	0	206205	0x33877ca	[CASE_NOJUMP]	17043	[pdfjs.js]	16934
206205	0	1	0	206205	0x33877c0	[CASE_NOJUMP]	17042	[pdfjs.js]	16934
200605	0.928541	0.0714588	186270	14335	0x34fcfee	[IFEQ_JUMP]	27666	[pdfjs.js]	27649
131530	0.999962	3.80141e-05	131525	5	0x277ae2b	[IFEQ_JUMP]	154	[pdfjs.js]	145
131525	0.999848	0.000152062	131505	20	0x277ae88	[IFEQ_JUMP]	158	[pdfjs.js]	145
118600	0.704258	0.295742	83525	35075	0x3388946	[IFEQ_JUMP]	17377	[pdfjs.js]	17373
71770	0.861363	0.138637	61820	9950	0x2fa37c5	[AND_JUMP]	1193	[pdfjs.js]	1192
57410	0.868316	0.131684	49850	7560	0x3387f06	[IFEQ_JUMP]	17083	[pdfjs.js]	17059
53180	0	1	0	53180	0x2778ea5	[IFNE_NOJUMP]	100	[pdfjs.js]	96
39030	0.991801	0.00819882	38710	320	0x3384b98	[IFEQ_JUMP]	16764	[pdfjs.js]	16751
38710	0.976104	0.0238956	37785	925	0x3384cf8	[IFEQ_JUMP]	16801	[pdfjs.js]	16751
37785	0.807728	0.192272	30520	7265	0x3384e20	[IFEQ_JUMP]	16820	[pdfjs.js]	16751
36974	2.7046e-05	0.999973	1	36973	0x277b0b8	[IFEQ_JUMP]	182	[pdfjs.js]	173
36973	0	1	0	36973	0x277b0ec	[IFEQ_NOJUMP]	184	[pdfjs.js]	173
35135	1	0	35135	0	0x2fa311c	[IFEQ_JUMP]	918	[pdfjs.js]	917
35075	0.621668	0.378332	21805	13270	0x3388985	[IFEQ_JUMP]	17381	[pdfjs.js]	17373
32065	0.931077	0.0689225	29855	2210	0x34f5497	[IFEQ_JUMP]	26596	[pdfjs.js]	26590
32065	0.931077	0.0689225	29855	2210	0x34f548d	[AND_JUMP]	26596	[pdfjs.js]	26590
30520	0.792267	0.207733	24180	6340	0x3384ed4	[AND_JUMP]	16839	[pdfjs.js]	16751
29855	1	0	29855	0	0x34f54ba	[IFEQ_JUMP]	26599	[pdfjs.js]	26590
29855	0.284374	0.715626	8490	21365	0x34f54e2	[AND_JUMP]	26603	[pdfjs.js]	26590
27500	0.000181818	0.999818	5	27495	0x34f96ac	[IFEQ_JUMP]	27285	[pdfjs.js]	27284
27175	0.475621	0.524379	12925	14250	0x3384833	[IFNE_JUMP]	17074	[pdfjs.js]	17068
27175	0.366697	0.633303	9965	17210	0x338480b	[AND_JUMP]	17074	[pdfjs.js]	17068
25775	1	0	25775	0	0x34f6252	[IFNE_JUMP]	26763	[pdfjs.js]	26758
25775	0.999418	0.000581959	25760	15	0x34f61d3	[IFEQ_JUMP]	26764	[pdfjs.js]	26758
25760	0.997477	0.00252329	25695	65	0x34f61e5	[IFEQ_JUMP]	26766	[pdfjs.js]	26758
25695	0.999611	0.000389181	25685	10	0x34f621a	[IFEQ_JUMP]	26769	[pdfjs.js]	26758
25685	0.358186	0.641814	9200	16485	0x34f6245	[IFEQ_JUMP]	26771	[pdfjs.js]	26758
25340	0.818272	0.181728	20735	4605	0x3384f1f	[IFEQ_JUMP]	16843	[pdfjs.js]	16751
25340	0.108327	0.891673	2745	22595	0x3384f13	[OR_JUMP]	16843	[pdfjs.js]	16751
25340	0	1	0	25340	0x3384f08	[AND_NOJUMP]	16843	[pdfjs.js]	16751
24180	1	0	24180	0	0x3384edf	[IFEQ_JUMP]	16839	[pdfjs.js]	16751
22080	0.945652	0.0543478	20880	1200	0x3384f59	[AND_JUMP]	16852	[pdfjs.js]	16751
21250	0.830118	0.169882	17640	3610	0x34f59b3	[IFNE_JUMP]	26699	[pdfjs.js]	26618
21250	0	1	0	21250	0x34f56a8	[CASE_NOJUMP]	26627	[pdfjs.js]	26618
21250	0.000235294	0.999765	5	21245	0x34f56b2	[CASE_JUMP]	26631	[pdfjs.js]	26618
21245	0.170158	0.829842	3615	17630	0x34f56bc	[CASE_JUMP]	26635	[pdfjs.js]	26618
20880	1	0	20880	0	0x3384f8e	[IFEQ_JUMP]	16856	[pdfjs.js]	16751
20880	1	0	20880	0	0x3384f79	[IFEQ_JUMP]	16854	[pdfjs.js]	16751
20880	1	0	20880	0	0x3384f66	[IFEQ_JUMP]	16852	[pdfjs.js]	16751
20840	0.671785	0.328215	14000	6840	0x338553c	[IFNE_JUMP]	16963	[pdfjs.js]	16958
20840	0	1	0	20840	0x3385513	[AND_NOJUMP]	16963	[pdfjs.js]	16958
20085	0.471496	0.528504	9470	10615	0x2fa3782	[AND_JUMP]	1173	[pdfjs.js]	1172
19505	0.510895	0.489105	9965	9540	0x338478d	[AND_JUMP]	17070	[pdfjs.js]	17068
19505	0.269418	0.730582	5255	14250	0x33847b4	[IFNE_JUMP]	17070	[pdfjs.js]	17068
17630	0.00510493	0.994895	90	17540	0x34f56c6	[CASE_JUMP]	26642	[pdfjs.js]	26618
17210	0.248983	0.751017	4285	12925	0x3384823	[OR_JUMP]	17074	[pdfjs.js]	17068
16485	0.0691538	0.930846	1140	15345	0x34f6260	[CASE_JUMP]	26778	[pdfjs.js]	26758
16050	1	0	16050	0	0x34f3753	[IFEQ_JUMP]	26311	[pdfjs.js]	26310
15345	0.0374715	0.962529	575	14770	0x34f626a	[CASE_JUMP]	26778	[pdfjs.js]	26758
14770	0.0629655	0.937035	930	13840	0x34f6274	[CASE_JUMP]	26778	[pdfjs.js]	26758
14375	0.0643478	0.935652	925	13450	0x338759e	[OR_JUMP]	16971	[pdfjs.js]	16934
14090	1	0	14090	0	0x3325ab3	[IFEQ_JUMP]	2806	[pdfjs.js]	2685
14090	1	0	14090	0	0x3325a8e	[AND_JUMP]	2805	[pdfjs.js]	2685
14090	1	0	14090	0	0x3325a62	[IFEQ_JUMP]	2802	[pdfjs.js]	2685
14090	1	0	14090	0	0x3325955	[CASE_JUMP]	2782	[pdfjs.js]	2685
14090	1	0	14090	0	0x33258af	[IFEQ_JUMP]	2768	[pdfjs.js]	2685
14090	0	1	0	14090	0x3325933	[IFEQ_NOJUMP]	2778	[pdfjs.js]	2685
13840	0.0314306	0.968569	435	13405	0x34f627e	[CASE_JUMP]	26778	[pdfjs.js]	26758
13735	1	0	13735	0	0x34f3833	[IFEQ_JUMP]	26322	[pdfjs.js]	26321
13735	0.974154	0.0258464	13380	355	0x34f3871	[IFEQ_JUMP]	26326	[pdfjs.js]	26321
13680	0.5	0.5	6840	6840	0x33854c1	[IFNE_JUMP]	16959	[pdfjs.js]	16958
13680	0	1	0	13680	0x3385499	[AND_NOJUMP]	16959	[pdfjs.js]	16958
13440	0.879092	0.120908	11815	1625	0x34f5dab	[IFNE_JUMP]	26705	[pdfjs.js]	26702
13440	0	1	0	13440	0x34f5d8a	[AND_NOJUMP]	26705	[pdfjs.js]	26702
13405	0.0361805	0.963819	485	12920	0x34f6288	[CASE_JUMP]	26778	[pdfjs.js]	26758
13380	0.986547	0.0134529	13200	180	0x34f3948	[IFEQ_JUMP]	26336	[pdfjs.js]	26321
13200	0.549242	0.450758	7250	5950	0x34f3ae4	[IFEQ_JUMP]	26361	[pdfjs.js]	26321
12920	0.0626935	0.937307	810	12110	0x34f6292	[CASE_JUMP]	26779	[pdfjs.js]	26758
12290	0.995932	0.00406835	12240	50	0x34fdf18	[IFEQ_JUMP]	27793	[pdfjs.js]	27687
12110	0.0309661	0.969034	375	11735	0x34f629c	[CASE_JUMP]	26779	[pdfjs.js]	26758
11815	1	0	11815	0	0x34f5c99	[IFEQ_JUMP]	26707	[pdfjs.js]	26702
11800	1	0	11800	0	0x34fdbc1	[IFEQ_JUMP]	27722	[pdfjs.js]	27687
11735	0.0421815	0.957818	495	11240	0x34f62a6	[CASE_JUMP]	26779	[pdfjs.js]	26758
11520	0.923611	0.0763889	10640	880	0x3388033	[IFEQ_JUMP]	17110	[pdfjs.js]	17059
11240	0.0266904	0.97331	300	10940	0x34f62b0	[CASE_JUMP]	26779	[pdfjs.js]	26758
11160	0	1	0	11160	0x34f96ac	[IFEQ_NOJUMP]	27403	[pdfjs.js]	27402
10940	0.00959781	0.990402	105	10835	0x34f62ba	[CASE_JUMP]	26779	[pdfjs.js]	26758
10835	0.910475	0.0895247	9865	970	0x3387a84	[IFEQ_JUMP]	17048	[pdfjs.js]	16934
10835	0.270881	0.729119	2935	7900	0x34f62ce	[CASE_JUMP]	26780	[pdfjs.js]	26758
10835	0	1	0	10835	0x34f62c4	[CASE_NOJUMP]	26780	[pdfjs.js]	26758
9950	0.0819095	0.91809	815	9135	0x2fa37cf	[OR_JUMP]	1193	[pdfjs.js]	1192
9785	0.96372	0.03628	9430	355	0x34f38e8	[IFNE_JUMP]	26329	[pdfjs.js]	26321
9785	0.03628	0.96372	355	9430	0x34f38cc	[AND_JUMP]	26329	[pdfjs.js]	26321
9710	1	0	9710	0	0x33840b8	[IFEQ_JUMP]	16558	[pdfjs.js]	16484
9710	1	0	9710	0	0x3384037	[IFEQ_JUMP]	16552	[pdfjs.js]	16484
9710	1	0	9710	0	0x3383e8b	[OR_JUMP]	16515	[pdfjs.js]	16484
9710	1	0	9710	0	0x3383e4e	[IFEQ_JUMP]	16510	[pdfjs.js]	16484
9710	1	0	9710	0	0x3383e35	[IFEQ_JUMP]	16508	[pdfjs.js]	16484
9710	1	0	9710	0	0x3383d26	[CASE_JUMP]	16506	[pdfjs.js]	16484
9710	1	0	9710	0	0x338365f	[IFEQ_JUMP]	16608	[pdfjs.js]	16570
9710	0.994851	0.00514933	9660	50	0x338404e	[OR_JUMP]	16553	[pdfjs.js]	16484
9710	0	1	0	9710	0x3384094	[IFEQ_NOJUMP]	16557	[pdfjs.js]	16484
9710	0	1	0	9710	0x3384065	[IFEQ_NOJUMP]	16554	[pdfjs.js]	16484
9710	0	1	0	9710	0x3383e0e	[OR_NOJUMP]	16507	[pdfjs.js]	16484
9710	0	1	0	9710	0x3383d1c	[CASE_NOJUMP]	16498	[pdfjs.js]	16484
9710	0	1	0	9710	0x3383d12	[CASE_NOJUMP]	16490	[pdfjs.js]	16484
9540	0.453878	0.546122	4330	5210	0x33847a5	[OR_JUMP]	17070	[pdfjs.js]	17068
8585	1	0	8585	0	0x34f5566	[IFEQ_JUMP]	26614	[pdfjs.js]	26590
8585	1	0	8585	0	0x34f551e	[IFEQ_JUMP]	26605	[pdfjs.js]	26590
8585	0	1	0	8585	0x34f550f	[OR_NOJUMP]	26605	[pdfjs.js]	26590
8490	1	0	8490	0	0x34f54f1	[IFEQ_JUMP]	26603	[pdfjs.js]	26590
7900	0.456962	0.543038	3610	4290	0x34f62e2	[CASE_JUMP]	26782	[pdfjs.js]	26758
7900	0	1	0	7900	0x34f62d8	[CASE_NOJUMP]	26780	[pdfjs.js]	26758
7585	0.023731	0.976269	180	7405	0x3388330	[IFEQ_JUMP]	17253	[pdfjs.js]	17228
7560	0.00595238	0.994048	45	7515	0x3387f14	[CASE_JUMP]	17085	[pdfjs.js]	17059
7515	0.00598802	0.994012	45	7470	0x3387f1e	[CASE_JUMP]	17097	[pdfjs.js]	17059
7365	0.788187	0.211813	5805	1560	0x34fdd3c	[IFEQ_JUMP]	27756	[pdfjs.js]	27687
7250	0.50069	0.49931	3630	3620	0x34f3b8f	[IFEQ_JUMP]	26372	[pdfjs.js]	26321
6840	0.517544	0.482456	3540	3300	0x3326103	[IFEQ_JUMP]	2852	[pdfjs.js]	2823
5950	0.963866	0.0361345	5735	215	0x34f3b36	[IFEQ_JUMP]	26364	[pdfjs.js]	26321
5950	0.82605	0.17395	4915	1035	0x34f3b15	[AND_JUMP]	26364	[pdfjs.js]	26321
5805	0.994832	0.00516796	5775	30	0x34fdd5f	[IFEQ_JUMP]	27758	[pdfjs.js]	27687
5775	0.998268	0.0017316	5765	10	0x34fdd83	[IFEQ_JUMP]	27760	[pdfjs.js]	27687
4835	1	0	4835	0	0x34fcbc3	[IFEQ_JUMP]	27610	[pdfjs.js]	27602
4405	0.640182	0.359818	2820	1585	0x34f64e7	[IFNE_JUMP]	26816	[pdfjs.js]	26758
4405	0	1	0	4405	0x34f64c6	[AND_NOJUMP]	26816	[pdfjs.js]	26758
4290	0.378788	0.621212	1625	2665	0x34f62ec	[CASE_JUMP]	26784	[pdfjs.js]	26758
4220	1	0	4220	0	0x33820aa	[IFEQ_JUMP]	16353	[pdfjs.js]	16348
4220	0.468009	0.531991	1975	2245	0x33820d0	[IFEQ_JUMP]	16355	[pdfjs.js]	16348
3620	1	0	3620	0	0x34f3bae	[IFEQ_JUMP]	26375	[pdfjs.js]	26321
3615	0.00138313	0.998617	5	3610	0x34f5714	[IFEQ_JUMP]	26636	[pdfjs.js]	26618
3550	0	1	0	3550	0x2fa4500	[IFEQ_NOJUMP]	2119	[pdfjs.js]	2117
3545	0.726375	0.273625	2575	970	0x3387ad0	[IFNE_JUMP]	17050	[pdfjs.js]	16934
3540	1	0	3540	0	0x33261fd	[IFEQ_JUMP]	2870	[pdfjs.js]	2823
3540	1	0	3540	0	0x3325b75	[IFEQ_JUMP]	2818	[pdfjs.js]	2685
3540	1	0	3540	0	0x332585c	[IFEQ_JUMP]	2758	[pdfjs.js]	2685
3540	1	0	3540	0	0x332583d	[IFEQ_JUMP]	2755	[pdfjs.js]	2685
3540	1	0	3540	0	0x3325815	[IFEQ_JUMP]	2750	[pdfjs.js]	2685
3540	1	0	3540	0	0x3325564	[IFEQ_JUMP]	2704	[pdfjs.js]	2685
3540	1	0	3540	0	0x3325540	[IFEQ_JUMP]	2700	[pdfjs.js]	2685
3540	1	0	3540	0	0x3325536	[AND_JUMP]	2700	[pdfjs.js]	2685
3540	1	0	3540	0	0x33254d2	[OR_JUMP]	2695	[pdfjs.js]	2685
3540	1	0	3540	0	0x2fb1110	[OR_JUMP]	2660	[pdfjs.js]	2656
3540	0	1	0	3540	0x33261df	[IFEQ_NOJUMP]	2867	[pdfjs.js]	2823
3540	0	1	0	3540	0x332580a	[OR_NOJUMP]	2750	[pdfjs.js]	2685
3540	0.0127119	0.987288	45	3495	0x33834e9	[IFEQ_JUMP]	16575	[pdfjs.js]	16570
3495	0.559371	0.440629	1955	1540	0x33834fc	[IFEQ_JUMP]	16577	[pdfjs.js]	16570
3475	0.909353	0.0906475	3160	315	0x333ae47	[IFNE_JUMP]	16902	[pdfjs.js]	16895
3300	1	0	3300	0	0x3326134	[IFEQ_JUMP]	2856	[pdfjs.js]	2823
2820	1	0	2820	0	0x34f6483	[IFEQ_JUMP]	26818	[pdfjs.js]	26758
2705	0.0240296	0.97597	65	2640	0x2fa21f2	[AND_JUMP]	14797	[pdfjs.js]	14794
2665	0.133208	0.866792	355	2310	0x34f62f6	[CASE_JUMP]	26787	[pdfjs.js]	26758
2655	0.0105461	0.989454	28	2627	0x2fa9e6c	[IFEQ_JUMP]	3310	[pdfjs.js]	3308
2365	0	1	0	2365	0x333ee7b	[IFEQ_NOJUMP]	16374	[pdfjs.js]	16361
2365	0.05074	0.94926	120	2245	0x333ee95	[AND_JUMP]	16376	[pdfjs.js]	16361
2310	0.15368	0.84632	355	1955	0x34f6300	[CASE_JUMP]	26788	[pdfjs.js]	26758
2000	1	0	2000	0	0x3383539	[IFEQ_JUMP]	16587	[pdfjs.js]	16570
2000	0.9775	0.0225	1955	45	0x3383509	[IFEQ_JUMP]	16582	[pdfjs.js]	16570
1955	0.0971867	0.902813	190	1765	0x34f630a	[CASE_JUMP]	26791	[pdfjs.js]	26758
1930	1	0	1930	0	0x2fa315c	[IFEQ_JUMP]	925	[pdfjs.js]	924
1765	0.101983	0.898017	180	1585	0x34f6314	[CASE_JUMP]	26800	[pdfjs.js]	26758
1585	1	0	1585	0	0x34f6515	[IFEQ_JUMP]	26827	[pdfjs.js]	26758
1585	1	0	1585	0	0x34f6505	[IFEQ_JUMP]	26825	[pdfjs.js]	26758
1585	1	0	1585	0	0x34f64f5	[IFEQ_JUMP]	26823	[pdfjs.js]	26758
1585	0	1	0	1585	0x34f6332	[CASE_NOJUMP]	26810	[pdfjs.js]	26758
1585	0	1	0	1585	0x34f6328	[CASE_NOJUMP]	26807	[pdfjs.js]	26758
1585	0	1	0	1585	0x34f631e	[CASE_NOJUMP]	26806	[pdfjs.js]	26758
1520	1	0	1520	0	0x3371acd	[IFNE_JUMP]	13422	[pdfjs.js]	13274
1520	1	0	1520	0	0x3371205	[IFEQ_JUMP]	13423	[pdfjs.js]	13274
1520	0.996711	0.00328947	1515	5	0x337123f	[IFEQ_JUMP]	13428	[pdfjs.js]	13274
1515	0.60066	0.39934	910	605	0x337125b	[IFEQ_JUMP]	13432	[pdfjs.js]	13274
1435	0.874564	0.125436	1255	180	0x34f3a42	[IFNE_JUMP]	26339	[pdfjs.js]	26321
1435	0.125436	0.874564	180	1255	0x34f3a26	[AND_JUMP]	26339	[pdfjs.js]	26321
1430	0.160839	0.839161	230	1200	0x332be2b	[IFEQ_JUMP]	3898	[pdfjs.js]	3897
1385	0.743682	0.256318	1030	355	0x3327a53	[OR_JUMP]	3332	[pdfjs.js]	3330
1385	0.0361011	0.963899	50	1335	0x3327a76	[IFEQ_JUMP]	3333	[pdfjs.js]	3330
1350	1	0	1350	0	0x33887c2	[IFEQ_JUMP]	17338	[pdfjs.js]	17321
1350	1	0	1350	0	0x338795b	[IFEQ_JUMP]	17019	[pdfjs.js]	16934
1350	1	0	1350	0	0x3387855	[IFEQ_JUMP]	17006	[pdfjs.js]	16934
1350	0	1	0	1350	0x3387846	[OR_NOJUMP]	17006	[pdfjs.js]	16934
1350	0	1	0	1350	0x3387837	[OR_NOJUMP]	17006	[pdfjs.js]	16934
1335	0.011236	0.988764	15	1320	0x3327a84	[IFEQ_JUMP]	3334	[pdfjs.js]	3330
1255	1	0	1255	0	0x34f39da	[IFEQ_JUMP]	26345	[pdfjs.js]	26321
1255	1	0	1255	0	0x34f398f	[IFEQ_JUMP]	26340	[pdfjs.js]	26321
1040	0	1	0	1040	0x336bb1a	[AND_NOJUMP]	17270	[pdfjs.js]	17265
930	1	0	930	0	0x333aed9	[OR_JUMP]	16913	[pdfjs.js]	16895
925	0.989189	0.0108108	915	10	0x338949f	[IFEQ_JUMP]	17474	[pdfjs.js]	17464
925	0.902703	0.0972973	835	90	0x333d8db	[IFEQ_JUMP]	15171	[pdfjs.js]	15151
925	0.535135	0.464865	495	430	0x333c8f9	[IFNE_JUMP]	15066	[pdfjs.js]	15048
925	0	1	0	925	0x3387647	[IFEQ_NOJUMP]	16978	[pdfjs.js]	16934
925	0	1	0	925	0x3384d08	[IFEQ_NOJUMP]	16802	[pdfjs.js]	16751
925	0	1	0	925	0x333d8d1	[OR_NOJUMP]	15171	[pdfjs.js]	15151
925	0.0486486	0.951351	45	880	0x333c8e1	[AND_JUMP]	15066	[pdfjs.js]	15048
910	1	0	910	0	0x3371aaa	[IFEQ_JUMP]	13618	[pdfjs.js]	13274
910	0	1	0	910	0x3371a60	[IFEQ_NOJUMP]	13616	[pdfjs.js]	13274
770	1	0	770	0	0x2fa366f	[IFEQ_JUMP]	1162	[pdfjs.js]	1152
680	0.404412	0.595588	275	405	0x333c504	[IFNE_JUMP]	15030	[pdfjs.js]	15022
665	1	0	665	0	0x277d2ab	[IFNE_JUMP]	2310	[pdfjs.js]	2289
665	1	0	665	0	0x277d16f	[IFEQ_JUMP]	2311	[pdfjs.js]	2289
665	1	0	665	0	0x277d15d	[AND_JUMP]	2311	[pdfjs.js]	2289
665	0.992481	0.0075188	660	5	0x277d255	[IFEQ_JUMP]	2337	[pdfjs.js]	2289
665	0.0902256	0.909774	60	605	0x277d1a3	[IFEQ_JUMP]	2318	[pdfjs.js]	2289
660	0.628788	0.371212	415	245	0x277d26e	[AND_JUMP]	2344	[pdfjs.js]	2289
660	0	1	0	660	0x277d261	[AND_NOJUMP]	2344	[pdfjs.js]	2289
605	1	0	605	0	0x337156a	[IFEQ_JUMP]	13482	[pdfjs.js]	13274
605	1	0	605	0	0x3371553	[AND_JUMP]	13482	[pdfjs.js]	13274
605	1	0	605	0	0x337135a	[IFEQ_JUMP]	13449	[pdfjs.js]	13274
605	1	0	605	0	0x3371334	[AND_JUMP]	13449	[pdfjs.js]	13274
605	1	0	605	0	0x337128d	[IFEQ_JUMP]	13435	[pdfjs.js]	13274
605	0.900826	0.0991736	545	60	0x3371785	[IFEQ_JUMP]	13524	[pdfjs.js]	13274
605	0	1	0	605	0x337180c	[CASE_NOJUMP]	13550	[pdfjs.js]	13274
605	0	1	0	605	0x3371802	[CASE_NOJUMP]	13536	[pdfjs.js]	13274
605	0	1	0	605	0x33717f8	[CASE_NOJUMP]	13533	[pdfjs.js]	13274
605	0	1	0	605	0x33717ee	[CASE_NOJUMP]	13532	[pdfjs.js]	13274
605	0	1	0	605	0x3371325	[OR_NOJUMP]	13449	[pdfjs.js]	13274
545	1	0	545	0	0x33717c3	[IFEQ_JUMP]	13526	[pdfjs.js]	13274
540	0.916667	0.0833333	495	45	0x3389caa	[IFNE_JUMP]	17514	[pdfjs.js]	17485
495	0.494949	0.505051	245	250	0x3389bcd	[IFEQ_JUMP]	17503	[pdfjs.js]	17485
495	0.363636	0.636364	180	315	0x333ae08	[IFNE_JUMP]	16897	[pdfjs.js]	16895
450	0.9	0.1	405	45	0x3388ca5	[IFNE_JUMP]	17530	[pdfjs.js]	17400
450	0.9	0.1	405	45	0x3382ac9	[IFNE_JUMP]	16342	[pdfjs.js]	16206
450	0.9	0.1	405	45	0x3382a83	[IFNE_JUMP]	16338	[pdfjs.js]	16206
425	0.117647	0.882353	50	375	0x34f9cc5	[IFEQ_JUMP]	27330	[pdfjs.js]	27328
415	1	0	415	0	0x277d288	[IFEQ_JUMP]	2344	[pdfjs.js]	2289
405	0.839506	0.160494	340	65	0x33853e3	[IFNE_JUMP]	16924	[pdfjs.js]	16917
405	0	1	0	405	0x333c533	[IFNE_NOJUMP]	15033	[pdfjs.js]	15022
355	1	0	355	0	0x34f3902	[IFEQ_JUMP]	26331	[pdfjs.js]	26321
355	0	1	0	355	0x3327a66	[OR_NOJUMP]	3332	[pdfjs.js]	3330
320	0.53125	0.46875	170	150	0x3384bb4	[IFEQ_JUMP]	16768	[pdfjs.js]	16751
320	0	1	0	320	0x34f34d1	[AND_NOJUMP]	26581	[pdfjs.js]	26580
310	0.83871	0.16129	260	50	0x34f8d31	[OR_JUMP]	27240	[pdfjs.js]	27238
310	0.306452	0.693548	95	215	0x34f8d53	[OR_JUMP]	27242	[pdfjs.js]	27238
245	0.265306	0.734694	65	180	0x3389bff	[IFEQ_JUMP]	17507	[pdfjs.js]	17485
240	1	0	240	0	0x33262b6	[IFEQ_JUMP]	2884	[pdfjs.js]	2823
240	1	0	240	0	0x3326016	[IFEQ_JUMP]	2836	[pdfjs.js]	2823
240	1	0	240	0	0x3326003	[IFEQ_JUMP]	2834	[pdfjs.js]	2823
240	1	0	240	0	0x3325fa9	[OR_JUMP]	2830	[pdfjs.js]	2823
240	0	1	0	240	0x3325f99	[IFEQ_NOJUMP]	2829	[pdfjs.js]	2823
225	0.8	0.2	180	45	0x3388299	[IFEQ_JUMP]	17235	[pdfjs.js]	17228
220	0	1	0	220	0x2fa388d	[AND_NOJUMP]	1205	[pdfjs.js]	1204
220	0	1	0	220	0x2fa3882	[AND_NOJUMP]	1205	[pdfjs.js]	1204
215	1	0	215	0	0x332c23c	[IFEQ_JUMP]	3641	[pdfjs.js]	3607
215	0.976744	0.0232558	210	5	0x332c1ae	[IFEQ_JUMP]	3634	[pdfjs.js]	3607
215	0	1	0	215	0x332c273	[IFEQ_NOJUMP]	3645	[pdfjs.js]	3607
215	0	1	0	215	0x332c21f	[OR_NOJUMP]	3640	[pdfjs.js]	3607
215	0	1	0	215	0x332c201	[OR_NOJUMP]	3640	[pdfjs.js]	3607
215	0.0232558	0.976744	5	210	0x332c22d	[OR_JUMP]	3641	[pdfjs.js]	3607
210	1	0	210	0	0x332e562	[IFEQ_JUMP]	3938	[pdfjs.js]	3902
210	1	0	210	0	0x332e558	[AND_JUMP]	3938	[pdfjs.js]	3902
210	1	0	210	0	0x332e4d8	[IFEQ_JUMP]	3929	[pdfjs.js]	3902
210	1	0	210	0	0x332e4a5	[IFEQ_JUMP]	3926	[pdfjs.js]	3902
210	1	0	210	0	0x332e3af	[IFEQ_JUMP]	3917	[pdfjs.js]	3902
210	1	0	210	0	0x332e36f	[IFEQ_JUMP]	3911	[pdfjs.js]	3902
210	1	0	210	0	0x332d13a	[IFEQ_JUMP]	3895	[pdfjs.js]	3891
210	1	0	210	0	0x332d12b	[IFEQ_JUMP]	3893	[pdfjs.js]	3891
210	0.97619	0.0238095	205	5	0x27771cd	[IFNE_JUMP]	121	[pdfjs.js]	120
210	0.761905	0.238095	160	50	0x332e5ed	[OR_JUMP]	3951	[pdfjs.js]	3902
210	0.238095	0.761905	50	160	0x332e600	[IFEQ_JUMP]	3951	[pdfjs.js]	3902
210	0	1	0	210	0x332e48c	[OR_NOJUMP]	3925	[pdfjs.js]	3902
210	0	1	0	210	0x332e47f	[OR_NOJUMP]	3925	[pdfjs.js]	3902
210	0	1	0	210	0x332e466	[OR_NOJUMP]	3924	[pdfjs.js]	3902
210	0	1	0	210	0x332e459	[OR_NOJUMP]	3924	[pdfjs.js]	3902
210	0	1	0	210	0x332e39e	[IFEQ_NOJUMP]	3916	[pdfjs.js]	3902
210	0	1	0	210	0x332c1da	[IFEQ_NOJUMP]	3636	[pdfjs.js]	3607
205	0	1	0	205	0x2777178	[IFEQ_NOJUMP]	123	[pdfjs.js]	120
200	1	0	200	0	0x277d111	[IFEQ_JUMP]	2299	[pdfjs.js]	2289
200	0.975	0.025	195	5	0x2faca11	[IFEQ_JUMP]	1767	[pdfjs.js]	1764
200	0.975	0.025	195	5	0x277d0f3	[OR_JUMP]	2295	[pdfjs.js]	2289
190	0.0526316	0.947368	10	180	0x34f639f	[IFEQ_JUMP]	26793	[pdfjs.js]	26758
180	1	0	180	0	0x34f3a5c	[IFEQ_JUMP]	26349	[pdfjs.js]	26321
180	0.694444	0.305556	125	55	0x34f3a91	[IFEQ_JUMP]	26354	[pdfjs.js]	26321
180	0	1	0	180	0x34f63fa	[IFEQ_NOJUMP]	26802	[pdfjs.js]	26758
170	0.941176	0.0588235	160	10	0x34f5f5a	[IFEQ_JUMP]	26734	[pdfjs.js]	26729
170	0.529412	0.470588	90	80	0x3384c60	[OR_JUMP]	16789	[pdfjs.js]	16751
170	0.205882	0.794118	35	135	0x3384c6c	[IFEQ_JUMP]	16789	[pdfjs.js]	16751
160	1	0	160	0	0x34f604b	[IFEQ_JUMP]	26750	[pdfjs.js]	26729
160	1	0	160	0	0x34f5fc8	[IFEQ_JUMP]	26743	[pdfjs.js]	26729
160	1	0	160	0	0x34f5f68	[IFEQ_JUMP]	26737	[pdfjs.js]	26729
160	0	1	0	160	0x34f602e	[IFNE_NOJUMP]	26747	[pdfjs.js]	26729
160	0	1	0	160	0x34f5fa3	[IFEQ_NOJUMP]	26741	[pdfjs.js]	26729
150	1	0	150	0	0x34f424a	[IFEQ_JUMP]	26449	[pdfjs.js]	26447
140	0.642857	0.357143	90	50	0x34f8f1a	[IFEQ_JUMP]	27264	[pdfjs.js]	27259
140	0.357143	0.642857	50	90	0x34f9fbd	[IFNE_JUMP]	27364	[pdfjs.js]	27350
130	0.5	0.5	65	65	0x33853a9	[IFNE_JUMP]	16918	[pdfjs.js]	16917
130	0	1	0	130	0x34f3514	[AND_NOJUMP]	26584	[pdfjs.js]	26580
120	1	0	120	0	0x333eea8	[IFEQ_JUMP]	16376	[pdfjs.js]	16361
115	1	0	115	0	0x2faa6c8	[IFEQ_JUMP]	1312	[pdfjs.js]	1311
95	0.105263	0.894737	10	85	0x2fa3815	[AND_JUMP]	1197	[pdfjs.js]	1196
90	1	0	90	0	0x34f9fd0	[IFEQ_JUMP]	27371	[pdfjs.js]	27350
90	1	0	90	0	0x34f9f29	[IFEQ_JUMP]	27353	[pdfjs.js]	27350
90	0.888889	0.111111	80	10	0x34f57a8	[CASE_JUMP]	26669	[pdfjs.js]	26618
90	0.5	0.5	45	45	0x336b9d3	[IFNE_JUMP]	17216	[pdfjs.js]	17207
90	0	1	0	90	0x34f5907	[AND_NOJUMP]	26677	[pdfjs.js]	26618
90	0	1	0	90	0x34f58b9	[AND_NOJUMP]	26673	[pdfjs.js]	26618
90	0	1	0	90	0x34f579e	[CASE_NOJUMP]	26666	[pdfjs.js]	26618
90	0	1	0	90	0x34f5794	[CASE_NOJUMP]	26665	[pdfjs.js]	26618
90	0	1	0	90	0x34f578a	[CASE_NOJUMP]	26664	[pdfjs.js]	26618
90	0	1	0	90	0x34f5780	[CASE_NOJUMP]	26661	[pdfjs.js]	26618
90	0	1	0	90	0x34f5776	[CASE_NOJUMP]	26658	[pdfjs.js]	26618
90	0	1	0	90	0x34f576c	[CASE_NOJUMP]	26655	[pdfjs.js]	26618
90	0	1	0	90	0x34f5762	[CASE_NOJUMP]	26652	[pdfjs.js]	26618
90	0	1	0	90	0x34f5758	[CASE_NOJUMP]	26649	[pdfjs.js]	26618
90	0	1	0	90	0x34f574e	[CASE_NOJUMP]	26645	[pdfjs.js]	26618
85	0.941176	0.0588235	80	5	0x2fa381f	[OR_JUMP]	1197	[pdfjs.js]	1196
75	1	0	75	0	0x350aea5	[IFEQ_JUMP]	29597	[pdfjs.js]	29592
75	1	0	75	0	0x2fa543d	[IFEQ_JUMP]	29559	[pdfjs.js]	29546
75	1	0	75	0	0x2fa5368	[IFEQ_JUMP]	29548	[pdfjs.js]	29546
65	1	0	65	0	0x3385405	[OR_JUMP]	16927	[pdfjs.js]	16917
65	1	0	65	0	0x2fa2204	[IFEQ_JUMP]	14797	[pdfjs.js]	14794
65	0.846154	0.153846	55	10	0x34f6202	[IFEQ_JUMP]	26767	[pdfjs.js]	26758
65	0.307692	0.692308	20	45	0x2fa6367	[IFEQ_JUMP]	1253	[pdfjs.js]	1248
65	0	1	0	65	0x34f61f3	[OR_NOJUMP]	26767	[pdfjs.js]	26758
60	1	0	60	0	0x34f3429	[IFEQ_JUMP]	29581	[pdfjs.js]	29579
60	1	0	60	0	0x332d67a	[IFEQ_JUMP]	4072	[pdfjs.js]	4070
60	1	0	60	0	0x332d493	[IFEQ_JUMP]	4046	[pdfjs.js]	4032
60	1	0	60	0	0x332d44b	[IFEQ_JUMP]	4035	[pdfjs.js]	4032
60	1	0	60	0	0x2fb0bb6	[IFEQ_JUMP]	2617	[pdfjs.js]	2577
60	1	0	60	0	0x2fb0b96	[IFEQ_JUMP]	2616	[pdfjs.js]	2577
60	1	0	60	0	0x2fb0b76	[IFEQ_JUMP]	2614	[pdfjs.js]	2577
60	1	0	60	0	0x2fb0b48	[IFEQ_JUMP]	2613	[pdfjs.js]	2577
60	1	0	60	0	0x2fb0b31	[OR_JUMP]	2612	[pdfjs.js]	2577
60	1	0	60	0	0x2fb0b22	[IFEQ_JUMP]	2609	[pdfjs.js]	2577
60	1	0	60	0	0x2fb0aab	[IFEQ_JUMP]	2593	[pdfjs.js]	2577
60	1	0	60	0	0x2fb0a1f	[IFEQ_JUMP]	2581	[pdfjs.js]	2577
60	1	0	60	0	0x277d208	[IFEQ_JUMP]	2327	[pdfjs.js]	2289
60	0.75	0.25	45	15	0x2fafdd5	[OR_JUMP]	13334	[pdfjs.js]	13295
60	0.25	0.75	15	45	0x336bdb9	[IFEQ_JUMP]	13289	[pdfjs.js]	13284
60	0.25	0.75	15	45	0x2fafc7b	[IFEQ_JUMP]	13305	[pdfjs.js]	13295
60	0	1	0	60	0x332d484	[OR_NOJUMP]	4046	[pdfjs.js]	4032
60	0	1	0	60	0x2fb0c1f	[IFEQ_NOJUMP]	2625	[pdfjs.js]	2577
60	0	1	0	60	0x2fb0a98	[OR_NOJUMP]	2592	[pdfjs.js]	2577
60	0	1	0	60	0x2fb0a45	[IFEQ_NOJUMP]	2585	[pdfjs.js]	2577
60	0	1	0	60	0x2fafc1c	[OR_NOJUMP]	13302	[pdfjs.js]	13295
56	0.982143	0.0178571	55	1	0x277e425	[IFEQ_JUMP]	353	[pdfjs.js]	351
55	0.909091	0.0909091	50	5	0x34fda1b	[IFEQ_JUMP]	27694	[pdfjs.js]	27687
55	0.0909091	0.909091	5	50	0x34fda00	[IFEQ_JUMP]	27690	[pdfjs.js]	27687
55	0.0909091	0.909091	5	50	0x34f3a9c	[IFEQ_JUMP]	26355	[pdfjs.js]	26321
50	1	0	50	0	0x34fde82	[IFEQ_JUMP]	27781	[pdfjs.js]	27687
50	1	0	50	0	0x34fdc0f	[IFEQ_JUMP]	27734	[pdfjs.js]	27687
50	1	0	50	0	0x34faa4c	[IFEQ_JUMP]	27588	[pdfjs.js]	27575
50	1	0	50	0	0x34faa1e	[IFEQ_JUMP]	27586	[pdfjs.js]	27575
50	1	0	50	0	0x34fa9e7	[IFEQ_JUMP]	27584	[pdfjs.js]	27575
50	1	0	50	0	0x34fa9b6	[IFEQ_JUMP]	27582	[pdfjs.js]	27575
50	1	0	50	0	0x34f6882	[IFNE_JUMP]	26833	[pdfjs.js]	26831
50	1	0	50	0	0x34f4858	[IFEQ_JUMP]	26504	[pdfjs.js]	26502
50	1	0	50	0	0x34f4841	[OR_JUMP]	26503	[pdfjs.js]	26502
50	1	0	50	0	0x34f4403	[IFEQ_JUMP]	26473	[pdfjs.js]	26451
50	1	0	50	0	0x34f43bb	[IFEQ_JUMP]	26468	[pdfjs.js]	26451
50	1	0	50	0	0x34f4351	[IFEQ_JUMP]	26461	[pdfjs.js]	26451
50	0.9	0.1	45	5	0x2fa1a8e	[IFEQ_JUMP]	14476	[pdfjs.js]	14473
50	0	1	0	50	0x34fdc39	[IFEQ_NOJUMP]	27737	[pdfjs.js]	27687
50	0	1	0	50	0x34fa9aa	[OR_NOJUMP]	27582	[pdfjs.js]	27575
50	0	1	0	50	0x34f683d	[IFEQ_NOJUMP]	26835	[pdfjs.js]	26831
50	0	1	0	50	0x34f682e	[OR_NOJUMP]	26835	[pdfjs.js]	26831
50	0	1	0	50	0x34f4850	[IFEQ_NOJUMP]	26503	[pdfjs.js]	26502
50	0	1	0	50	0x34f4610	[IFEQ_NOJUMP]	26482	[pdfjs.js]	26479
50	0	1	0	50	0x3327af2	[IFEQ_NOJUMP]	3338	[pdfjs.js]	3330
50	0	1	0	50	0x3327ae4	[IFEQ_NOJUMP]	3337	[pdfjs.js]	3330
50	0	1	0	50	0x3327ad4	[OR_NOJUMP]	3336	[pdfjs.js]	3330
50	0	1	0	50	0x3327ac1	[OR_NOJUMP]	3336	[pdfjs.js]	3330
45	1	0	45	0	0x3387fd1	[IFEQ_JUMP]	17100	[pdfjs.js]	17059
45	1	0	45	0	0x338315d	[IFEQ_JUMP]	16447	[pdfjs.js]	16432
45	1	0	45	0	0x338314d	[AND_JUMP]	16447	[pdfjs.js]	16432
45	1	0	45	0	0x33828c5	[IFEQ_JUMP]	16247	[pdfjs.js]	16206
45	1	0	45	0	0x338283d	[IFEQ_JUMP]	16239	[pdfjs.js]	16206
45	1	0	45	0	0x3372ed9	[IFEQ_JUMP]	14016	[pdfjs.js]	13896
45	1	0	45	0	0x3372dc9	[OR_JUMP]	14003	[pdfjs.js]	13896
45	1	0	45	0	0x3372dba	[OR_JUMP]	14002	[pdfjs.js]	13896
45	1	0	45	0	0x3372cfc	[IFEQ_JUMP]	13983	[pdfjs.js]	13896
45	1	0	45	0	0x3372c60	[IFEQ_JUMP]	13975	[pdfjs.js]	13896
45	1	0	45	0	0x3372c29	[OR_JUMP]	13972	[pdfjs.js]	13896
45	1	0	45	0	0x3372c0a	[OR_JUMP]	13971	[pdfjs.js]	13896
45	1	0	45	0	0x3372a19	[IFEQ_JUMP]	13923	[pdfjs.js]	13896
45	1	0	45	0	0x33729e9	[IFEQ_JUMP]	13920	[pdfjs.js]	13896
45	1	0	45	0	0x3372942	[IFEQ_JUMP]	13905	[pdfjs.js]	13896
45	1	0	45	0	0x337060e	[IFEQ_JUMP]	13835	[pdfjs.js]	13829
45	1	0	45	0	0x33701af	[IFEQ_JUMP]	13655	[pdfjs.js]	13626
45	1	0	45	0	0x337006b	[IFEQ_JUMP]	13634	[pdfjs.js]	13626
45	1	0	45	0	0x337003d	[IFEQ_JUMP]	13631	[pdfjs.js]	13626
45	1	0	45	0	0x333ede1	[IFEQ_JUMP]	16364	[pdfjs.js]	16361
45	1	0	45	0	0x333dcc4	[OR_JUMP]	15251	[pdfjs.js]	15151
45	1	0	45	0	0x333dc04	[OR_JUMP]	15240	[pdfjs.js]	15151
45	1	0	45	0	0x333dbe3	[OR_JUMP]	15238	[pdfjs.js]	15151
45	1	0	45	0	0x333db47	[IFEQ_JUMP]	15230	[pdfjs.js]	15151
45	1	0	45	0	0x333da6d	[IFEQ_JUMP]	15204	[pdfjs.js]	15151
45	1	0	45	0	0x333da58	[AND_JUMP]	15203	[pdfjs.js]	15151
45	1	0	45	0	0x333cc04	[IFEQ_JUMP]	15101	[pdfjs.js]	15077
45	1	0	45	0	0x333c221	[IFEQ_JUMP]	14998	[pdfjs.js]	14996
45	1	0	45	0	0x333b8b6	[IFEQ_JUMP]	14926	[pdfjs.js]	14828
45	1	0	45	0	0x333b7de	[IFEQ_JUMP]	14903	[pdfjs.js]	14828
45	1	0	45	0	0x333b786	[CASE_JUMP]	14898	[pdfjs.js]	14828
45	1	0	45	0	0x333b674	[IFEQ_JUMP]	14875	[pdfjs.js]	14828
45	1	0	45	0	0x333b62c	[IFEQ_JUMP]	14868	[pdfjs.js]	14828
45	1	0	45	0	0x333b5fd	[IFEQ_JUMP]	14860	[pdfjs.js]	14828
45	1	0	45	0	0x333b54e	[IFEQ_JUMP]	14845	[pdfjs.js]	14828
45	1	0	45	0	0x333925d	[IFEQ_JUMP]	14496	[pdfjs.js]	14472
45	1	0	45	0	0x332d559	[IFEQ_JUMP]	4059	[pdfjs.js]	4055
45	1	0	45	0	0x2fa28b2	[IFEQ_JUMP]	4018	[pdfjs.js]	4017
45	1	0	45	0	0x277c973	[CASE_JUMP]	1949	[pdfjs.js]	1934
45	1	0	45	0	0x277c94f	[IFEQ_JUMP]	1937	[pdfjs.js]	1934
45	0.777778	0.222222	35	10	0x3382393	[IFEQ_JUMP]	16282	[pdfjs.js]	16268
45	0.777778	0.222222	35	10	0x333dbc4	[IFEQ_JUMP]	15237	[pdfjs.js]	15151
45	0	1	0	45	0x35032eb	[IFEQ_NOJUMP]	29702	[pdfjs.js]	29649
45	0	1	0	45	0x338809e	[IFEQ_NOJUMP]	17118	[pdfjs.js]	17059
45	0	1	0	45	0x3388095	[AND_NOJUMP]	17118	[pdfjs.js]	17059
45	0	1	0	45	0x3382cf1	[IFEQ_NOJUMP]	16384	[pdfjs.js]	16383
45	0	1	0	45	0x3382823	[OR_NOJUMP]	16238	[pdfjs.js]	16206
45	0	1	0	45	0x3382809	[AND_NOJUMP]	16238	[pdfjs.js]	16206
45	0	1	0	45	0x33807b2	[IFEQ_NOJUMP]	16209	[pdfjs.js]	16207
45	0	1	0	45	0x3372da3	[OR_NOJUMP]	14001	[pdfjs.js]	13896
45	0	1	0	45	0x3372cd7	[IFEQ_NOJUMP]	13981	[pdfjs.js]	13896
45	0	1	0	45	0x3372cca	[IFEQ_NOJUMP]	13980	[pdfjs.js]	13896
45	0	1	0	45	0x33707fe	[OR_NOJUMP]	13864	[pdfjs.js]	13829
45	0	1	0	45	0x337078b	[IFEQ_NOJUMP]	13860	[pdfjs.js]	13829
45	0	1	0	45	0x337016a	[IFEQ_NOJUMP]	13652	[pdfjs.js]	13626
45	0	1	0	45	0x337001c	[OR_NOJUMP]	13629	[pdfjs.js]	13626
45	0	1	0	45	0x333da3d	[OR_NOJUMP]	15199	[pdfjs.js]	15151
45	0	1	0	45	0x333da27	[OR_NOJUMP]	15198	[pdfjs.js]	15151
45	0	1	0	45	0x333da0d	[OR_NOJUMP]	15197	[pdfjs.js]	15151
45	0	1	0	45	0x333d9f3	[OR_NOJUMP]	15196	[pdfjs.js]	15151
45	0	1	0	45	0x333d9d8	[OR_NOJUMP]	15195	[pdfjs.js]	15151
45	0	1	0	45	0x333d8aa	[IFEQ_NOJUMP]	15168	[pdfjs.js]	15151
45	0	1	0	45	0x333d85b	[OR_NOJUMP]	15152	[pdfjs.js]	15151
45	0	1	0	45	0x333b7cf	[OR_NOJUMP]	14903	[pdfjs.js]	14828
45	0	1	0	45	0x333930b	[IFEQ_NOJUMP]	14511	[pdfjs.js]	14472
45	0	1	0	45	0x333929c	[IFEQ_NOJUMP]	14505	[pdfjs.js]	14472
45	0	1	0	45	0x333924d	[OR_NOJUMP]	14496	[pdfjs.js]	14472
45	0	1	0	45	0x332df1a	[IFEQ_NOJUMP]	4081	[pdfjs.js]	4079
45	0	1	0	45	0x2fafd52	[IFEQ_NOJUMP]	13320	[pdfjs.js]	13295
45	0	1	0	45	0x2fafd24	[IFEQ_NOJUMP]	13318	[pdfjs.js]	13295
45	0	1	0	45	0x2fafcc7	[IFEQ_NOJUMP]	13308	[pdfjs.js]	13295
45	0	1	0	45	0x2782f51	[IFEQ_NOJUMP]	243	[pdfjs.js]	242
45	0	1	0	45	0x277c9f4	[IFEQ_NOJUMP]	1954	[pdfjs.js]	1934
45	0	1	0	45	0x277c969	[CASE_NOJUMP]	1945	[pdfjs.js]	1934
45	0	1	0	45	0x277c95f	[CASE_NOJUMP]	1941	[pdfjs.js]	1934
35	1	0	35	0	0x3384c90	[OR_JUMP]	16793	[pdfjs.js]	16751
35	0.857143	0.142857	30	5	0x332a56f	[IFNE_JUMP]	3369	[pdfjs.js]	3367
35	0	1	0	35	0x3384c9c	[IFEQ_NOJUMP]	16793	[pdfjs.js]	16751
35	0	1	0	35	0x3384c85	[AND_NOJUMP]	16793	[pdfjs.js]	16751
30	0.833333	0.166667	25	5	0x2fa711e	[IFEQ_JUMP]	841	[pdfjs.js]	840
30	0.666667	0.333333	20	10	0x2fa4fd5	[IFNE_JUMP]	485	[pdfjs.js]	482
25	1	0	25	0	0x2fa35cd	[IFEQ_JUMP]	1154	[pdfjs.js]	1152
25	1	0	25	0	0x2fa35bc	[AND_JUMP]	1154	[pdfjs.js]	1152
20	1	0	20	0	0x2faacf5	[IFEQ_JUMP]	1385	[pdfjs.js]	1367
20	1	0	20	0	0x2faac3c	[IFEQ_JUMP]	1368	[pdfjs.js]	1367
20	1	0	20	0	0x2faa825	[IFEQ_JUMP]	1330	[pdfjs.js]	1326
20	1	0	20	0	0x2faa7fe	[IFEQ_JUMP]	1327	[pdfjs.js]	1326
20	1	0	20	0	0x2faa627	[IFEQ_JUMP]	1306	[pdfjs.js]	1295
20	1	0	20	0	0x2faa5e8	[IFEQ_JUMP]	1299	[pdfjs.js]	1295
20	1	0	20	0	0x2faa5d1	[IFEQ_JUMP]	1296	[pdfjs.js]	1295
20	0.5	0.5	10	10	0x2faac5d	[IFEQ_JUMP]	1373	[pdfjs.js]	1367
20	0.5	0.5	10	10	0x2faa852	[OR_JUMP]	1335	[pdfjs.js]	1326
20	0.5	0.5	10	10	0x2fa4faa	[IFEQ_JUMP]	487	[pdfjs.js]	482
20	0.25	0.75	5	15	0x34fa1fe	[IFEQ_JUMP]	27390	[pdfjs.js]	27387
20	0	1	0	20	0x2fab1cf	[IFEQ_NOJUMP]	1413	[pdfjs.js]	1412
20	0	1	0	20	0x2fa59ff	[IFEQ_NOJUMP]	1406	[pdfjs.js]	1405
15	0	1	0	15	0x3384c2d	[IFEQ_NOJUMP]	16784	[pdfjs.js]	16751
10	1	0	10	0	0x34f57b2	[CASE_JUMP]	26669	[pdfjs.js]	26618
10	1	0	10	0	0x2faac95	[IFEQ_JUMP]	1376	[pdfjs.js]	1367
10	1	0	10	0	0x2faac8c	[AND_JUMP]	1376	[pdfjs.js]	1367
10	1	0	10	0	0x2fa4d64	[IFEQ_JUMP]	743	[pdfjs.js]	733
10	0.5	0.5	5	5	0x332c2cd	[IFNE_JUMP]	3620	[pdfjs.js]	3607
10	0.5	0.5	5	5	0x332b9b6	[IFEQ_JUMP]	3572	[pdfjs.js]	3570
10	0.5	0.5	5	5	0x3117d60	[IFNE_JUMP]	786	[pdfjs.js]	761
10	0.5	0.5	5	5	0x3117d04	[AND_JUMP]	774	[pdfjs.js]	761
10	0.5	0.5	5	5	0x2faacd7	[IFEQ_JUMP]	1381	[pdfjs.js]	1367
10	0.5	0.5	5	5	0x2fa4d2c	[IFEQ_JUMP]	742	[pdfjs.js]	733
10	0.5	0.5	5	5	0x277c402	[IFEQ_JUMP]	2240	[pdfjs.js]	2231
10	0	1	0	10	0x34f35ef	[OR_NOJUMP]	26556	[pdfjs.js]	26555
10	0	1	0	10	0x34f35e0	[OR_NOJUMP]	26556	[pdfjs.js]	26555
10	0	1	0	10	0x34f35d1	[OR_NOJUMP]	26556	[pdfjs.js]	26555
5	1	0	5	0	0x34fdb3a	[IFEQ_JUMP]	27711	[pdfjs.js]	27687
5	1	0	5	0	0x34fdb06	[IFEQ_JUMP]	27708	[pdfjs.js]	27687
5	1	0	5	0	0x34fdacc	[IFEQ_JUMP]	27705	[pdfjs.js]	27687
5	1	0	5	0	0x34fda8b	[IFEQ_JUMP]	27702	[pdfjs.js]	27687
5	1	0	5	0	0x34fda51	[IFEQ_JUMP]	27699	[pdfjs.js]	27687
5	1	0	5	0	0x34f6a60	[AND_JUMP]	26862	[pdfjs.js]	26853
5	1	0	5	0	0x3371115	[OR_JUMP]	13413	[pdfjs.js]	13274
5	1	0	5	0	0x33710fd	[OR_JUMP]	13411	[pdfjs.js]	13274
5	1	0	5	0	0x3371070	[OR_JUMP]	13282	[pdfjs.js]	13274
5	1	0	5	0	0x333965e	[IFEQ_JUMP]	14559	[pdfjs.js]	14533
5	1	0	5	0	0x332d944	[IFEQ_JUMP]	3874	[pdfjs.js]	3833
5	1	0	5	0	0x332d913	[IFEQ_JUMP]	3872	[pdfjs.js]	3833
5	1	0	5	0	0x332d7d9	[IFEQ_JUMP]	3849	[pdfjs.js]	3833
5	1	0	5	0	0x332c360	[IFEQ_JUMP]	3668	[pdfjs.js]	3607
5	1	0	5	0	0x332c321	[IFEQ_JUMP]	3655	[pdfjs.js]	3607
5	1	0	5	0	0x332c2ee	[IFEQ_JUMP]	3651	[pdfjs.js]	3607
5	1	0	5	0	0x332c127	[IFEQ_JUMP]	3624	[pdfjs.js]	3607
5	1	0	5	0	0x332b667	[IFEQ_JUMP]	3543	[pdfjs.js]	3522
5	1	0	5	0	0x332b643	[IFEQ_JUMP]	3535	[pdfjs.js]	3522
5	1	0	5	0	0x332b620	[IFEQ_JUMP]	3532	[pdfjs.js]	3522
5	1	0	5	0	0x332b5e7	[IFEQ_JUMP]	3530	[pdfjs.js]	3522
5	1	0	5	0	0x332aeb3	[IFEQ_JUMP]	3442	[pdfjs.js]	3438
5	1	0	5	0	0x332abad	[OR_JUMP]	3511	[pdfjs.js]	3501
5	1	0	5	0	0x33277d7	[IFEQ_JUMP]	3420	[pdfjs.js]	3417
5	1	0	5	0	0x33277ba	[AND_JUMP]	3420	[pdfjs.js]	3417
5	1	0	5	0	0x3118085	[IFEQ_JUMP]	830	[pdfjs.js]	828
5	1	0	5	0	0x3117dc7	[IFEQ_JUMP]	793	[pdfjs.js]	761
5	1	0	5	0	0x3117c44	[IFEQ_JUMP]	765	[pdfjs.js]	761
5	1	0	5	0	0x2fb083e	[IFEQ_JUMP]	3215	[pdfjs.js]	3214
5	1	0	5	0	0x2fad2d5	[IFEQ_JUMP]	1757	[pdfjs.js]	1747
5	1	0	5	0	0x2fad2c5	[AND_JUMP]	1757	[pdfjs.js]	1747
5	1	0	5	0	0x2facb47	[IFEQ_JUMP]	1828	[pdfjs.js]	1815
5	1	0	5	0	0x2fac556	[IFEQ_JUMP]	1681	[pdfjs.js]	1680
5	1	0	5	0	0x2fac43c	[IFEQ_JUMP]	1672	[pdfjs.js]	1665
5	1	0	5	0	0x2fac416	[IFEQ_JUMP]	1667	[pdfjs.js]	1665
5	1	0	5	0	0x2fa9a08	[IFEQ_JUMP]	3602	[pdfjs.js]	3584
5	1	0	5	0	0x2fa99b1	[IFEQ_JUMP]	3595	[pdfjs.js]	3584
5	1	0	5	0	0x2fa9553	[IFEQ_JUMP]	1094	[pdfjs.js]	1067
5	1	0	5	0	0x2fa94cc	[CASE_JUMP]	1087	[pdfjs.js]	1067
5	1	0	5	0	0x2fa5f78	[IFEQ_JUMP]	544	[pdfjs.js]	540
5	1	0	5	0	0x2fa5dfd	[IFEQ_JUMP]	528	[pdfjs.js]	525
5	1	0	5	0	0x2fa5cbb	[OR_JUMP]	509	[pdfjs.js]	506
5	1	0	5	0	0x2fa5c02	[IFEQ_JUMP]	502	[pdfjs.js]	499
5	1	0	5	0	0x2fa4e1a	[IFEQ_JUMP]	803	[pdfjs.js]	800
5	1	0	5	0	0x2fa272d	[OR_JUMP]	450	[pdfjs.js]	434
5	1	0	5	0	0x2fa26f1	[OR_JUMP]	447	[pdfjs.js]	434
5	1	0	5	0	0x2fa26b2	[IFEQ_JUMP]	444	[pdfjs.js]	434
5	1	0	5	0	0x2fa258f	[IFEQ_JUMP]	436	[pdfjs.js]	434
5	1	0	5	0	0x277ce59	[IFEQ_JUMP]	2483	[pdfjs.js]	2473
5	1	0	5	0	0x277ce45	[AND_JUMP]	2482	[pdfjs.js]	2473
5	1	0	5	0	0x277cdfa	[IFEQ_JUMP]	2477	[pdfjs.js]	2473
5	1	0	5	0	0x277cdc2	[IFEQ_JUMP]	2474	[pdfjs.js]	2473
5	1	0	5	0	0x277c660	[IFEQ_JUMP]	2357	[pdfjs.js]	2354
5	1	0	5	0	0x277c5ce	[IFEQ_JUMP]	2285	[pdfjs.js]	2280
5	1	0	5	0	0x2777632	[IFEQ_JUMP]	76	[pdfjs.js]	69
5	0.8	0.2	4	1	0x2facb30	[AND_JUMP]	1828	[pdfjs.js]	1815
5	0	1	0	5	0x34f702e	[IFEQ_NOJUMP]	26891	[pdfjs.js]	26890
5	0	1	0	5	0x34f6a6c	[IFEQ_NOJUMP]	26862	[pdfjs.js]	26853
5	0	1	0	5	0x34f6a2e	[IFEQ_NOJUMP]	26860	[pdfjs.js]	26853
5	0	1	0	5	0x34f6a13	[AND_NOJUMP]	26859	[pdfjs.js]	26853
5	0	1	0	5	0x34f69f5	[AND_NOJUMP]	26859	[pdfjs.js]	26853
5	0	1	0	5	0x34f69dd	[AND_NOJUMP]	26859	[pdfjs.js]	26853
5	0	1	0	5	0x337117f	[OR_NOJUMP]	13415	[pdfjs.js]	13274
5	0	1	0	5	0x337114d	[OR_NOJUMP]	13414	[pdfjs.js]	13274
5	0	1	0	5	0x33710bd	[IFEQ_NOJUMP]	13406	[pdfjs.js]	13274
5	0	1	0	5	0x33710a1	[IFEQ_NOJUMP]	13403	[pdfjs.js]	13274
5	0	1	0	5	0x3371089	[IFEQ_NOJUMP]	13400	[pdfjs.js]	13274
5	0	1	0	5	0x3339748	[IFEQ_NOJUMP]	14579	[pdfjs.js]	14533
5	0	1	0	5	0x33393aa	[IFEQ_NOJUMP]	14523	[pdfjs.js]	14472
5	0	1	0	5	0x3339375	[IFEQ_NOJUMP]	14519	[pdfjs.js]	14472
5	0	1	0	5	0x3339367	[AND_NOJUMP]	14519	[pdfjs.js]	14472
5	0	1	0	5	0x332d796	[IFEQ_NOJUMP]	3843	[pdfjs.js]	3833
5	0	1	0	5	0x332c2da	[AND_NOJUMP]	3651	[pdfjs.js]	3607
5	0	1	0	5	0x332c10e	[OR_NOJUMP]	3624	[pdfjs.js]	3607
5	0	1	0	5	0x332abe0	[IFEQ_NOJUMP]	3511	[pdfjs.js]	3501
5	0	1	0	5	0x3117f3d	[IFEQ_NOJUMP]	813	[pdfjs.js]	810
5	0	1	0	5	0x3117d17	[IFEQ_NOJUMP]	781	[pdfjs.js]	761
5	0	1	0	5	0x3117d0f	[IFNE_NOJUMP]	774	[pdfjs.js]	761
5	0	1	0	5	0x3117b39	[IFEQ_NOJUMP]	755	[pdfjs.js]	750
5	0	1	0	5	0x3117b0f	[IFEQ_NOJUMP]	753	[pdfjs.js]	750
5	0	1	0	5	0x2faf150	[IFEQ_NOJUMP]	2436	[pdfjs.js]	2434
5	0	1	0	5	0x2faca6a	[IFEQ_NOJUMP]	1771	[pdfjs.js]	1764
5	0	1	0	5	0x2fac82d	[IFEQ_NOJUMP]	1654	[pdfjs.js]	1646
5	0	1	0	5	0x2faa0ad	[IFEQ_NOJUMP]	1462	[pdfjs.js]	1459
5	0	1	0	5	0x2fa94c6	[CASE_NOJUMP]	1086	[pdfjs.js]	1067
5	0	1	0	5	0x2fa94be	[CASE_NOJUMP]	1083	[pdfjs.js]	1067
5	0	1	0	5	0x2fa94b6	[CASE_NOJUMP]	1082	[pdfjs.js]	1067
5	0	1	0	5	0x2fa94ae	[CASE_NOJUMP]	1079	[pdfjs.js]	1067
5	0	1	0	5	0x2fa94a7	[CASE_NOJUMP]	1078	[pdfjs.js]	1067
5	0	1	0	5	0x2fa949e	[CASE_NOJUMP]	1075	[pdfjs.js]	1067
5	0	1	0	5	0x2fa9496	[CASE_NOJUMP]	1074	[pdfjs.js]	1067
5	0	1	0	5	0x2fa71ce	[IFEQ_NOJUMP]	836	[pdfjs.js]	834
5	0	1	0	5	0x2fa6d05	[IFEQ_NOJUMP]	850	[pdfjs.js]	848
5	0	1	0	5	0x2fa600c	[IFEQ_NOJUMP]	551	[pdfjs.js]	540
5	0	1	0	5	0x2fa5dea	[OR_NOJUMP]	526	[pdfjs.js]	525
5	0	1	0	5	0x2fa5ccc	[IFEQ_NOJUMP]	509	[pdfjs.js]	506
5	0	1	0	5	0x2fa5bf1	[OR_NOJUMP]	502	[pdfjs.js]	499
5	0	1	0	5	0x2fa4aaa	[IFEQ_NOJUMP]	718	[pdfjs.js]	717
5	0	1	0	5	0x2fa3b07	[IFEQ_NOJUMP]	2068	[pdfjs.js]	2066
5	0	1	0	5	0x2fa2e06	[OR_NOJUMP]	456	[pdfjs.js]	452
5	0	1	0	5	0x2fa2df2	[OR_NOJUMP]	455	[pdfjs.js]	452
5	0	1	0	5	0x2fa2dde	[OR_NOJUMP]	455	[pdfjs.js]	452
5	0	1	0	5	0x2fa2dcb	[IFEQ_NOJUMP]	454	[pdfjs.js]	452
5	0	1	0	5	0x2fa2da9	[IFEQ_NOJUMP]	453	[pdfjs.js]	452
5	0	1	0	5	0x2fa26a3	[OR_NOJUMP]	444	[pdfjs.js]	434
5	0	1	0	5	0x277e501	[IFEQ_NOJUMP]	362	[pdfjs.js]	361
5	0	1	0	5	0x277cebd	[IFEQ_NOJUMP]	2493	[pdfjs.js]	2473
5	0	1	0	5	0x277ce2b	[AND_NOJUMP]	2482	[pdfjs.js]	2473
5	0	1	0	5	0x2777625	[OR_NOJUMP]	76	[pdfjs.js]	69
1	1	0	1	0	0x7faf34f4c2b2	[IFEQ_JUMP]	422	[pdfjs.js]	400
1	1	0	1	0	0x7faf34f4c23a	[IFEQ_JUMP]	412	[pdfjs.js]	400
1	1	0	1	0	0x3399d75	[IFEQ_JUMP]	33055	[pdfjs.js]	1
1	1	0	1	0	0x3399c0e	[IFEQ_JUMP]	206	[pdfjs.js]	1
1	1	0	1	0	0x2779e35	[IFEQ_JUMP]	37	[pdfjs.js]	33
1	0	1	0	1	0x7faf34f4c808	[IFEQ_NOJUMP]	3248	[pdfjs.js]	400
1	0	1	0	1	0x277a12d	[IFEQ_NOJUMP]	46	[run.js.pdfjs.js]	45
1	0	1	0	1	0x2779e16	[AND_NOJUMP]	36	[pdfjs.js]	33
1	0	1	0	1	0x2779e04	[AND_NOJUMP]	35	[pdfjs.js]	33
